________
__P__DP_
__D_____
________
________
____P___
_D______
________