W________W
W________W
W________W
W________W
.________W
.P___W___W
WWWWWWWWWW
