________
________
___D____
_____P__
________
_D______
___P____
________