W__WW____W
W________W
W________W
W________W
W__..____W
W__..B___W
WWWWWWWWWW
