_B_______B
___B_____P
___P______
B_BB_____B
P__B_B___P
_WPW_P_PBW
WWWWWWWWWW
