_____P_B__
_B_______P
_____B____
___B___B__
P_BB_____P
_WPW_PBP_W
WWWWWWWWWW
