_W______WW
WW___P____
_____W____
____BW__B_
__P__W__P_
__W_BW_BBW
WWWWWWWWWW
