__________
____WWWWW_
___W_____W
__W______.
_W_______W
W________W
W____P___W
W___...__W
W__P.D.__W
WWWWWWWWWW
