WWWWWW
WW___W
WW_WWW
WW_WDW
WW__PW
WWWWWW