WWBW_DW___
__W_WWW___
B_________
P_________
B_W___BB__
B_W_W_PWP_
WWWWWWWWWW
