WWBW_DW___
__W_WWW___
B_________
P__B______
B_W___BBB_
B_W_W_PWP_
WWWWWWWWWW
