WWBW_DW___
__W_WWW___
________P_
P_________
BBW__B_BB_
B_WBWP_WP_
WWWWWWWWWW
