____W_P_W_
____W_____
_________B
_____B__BB
__P_BBBP_B
P__WPB_WBW
WWWWWWWWWW
