W___W...WW
W____...__
W___...___
W___...W__
W__W...WB.
W__WB__WW.
WWWWWWWW_.
