____P_____
__________
___B______
_B_P___P__
_WBB___B__
_WPB_BPB__
WWWWWWWWWW
