__________
____B_____
__________
__B_____B_
________P_
PBP___BWB_
WWWWWWWWWW
