__________
__________
____B_____
_______B__
B_B_B__P__
P_P_P_BWB_
WWWWWWWWWW
