_________
_________
___BBB___
___VWB___
_BBVWH_O_
_WWWWWWW_
WWWWWWWWW