________
__D_____
_____P__
________
________
__P___D_
________
________