______D___
_B____W___
_P____W___
_W__W_W___
PW__W_W__B
BW_WW_WB_W
WWWWWWWWWW
