WWWWWW
WD_P_W
W____W
W____W
WD_P_W
WWWWWW