_ _ _ _ _ _
_ G _ _ G _
_ P _ _ P _
_ _ _ _ _ _
_ _ _ _ _ _
_ _ _ _ _ _