_____PW_W_
___P_WWBWW
_______W__
__P_______
________BP
_P_BBB__WB
WWWWWWWWWW
