______W_W_
___P_WWBWW
_______W__
__P_______
_______PB_
__PB_B__WB
WWWWWWWWWW
