___B_BWPWB
___P_WWBWW
_______W__
__________
__B_____BP
__P____PWB
WWWWWWWWWW
