___B__W_W_
_B___WWBWW
___P___W__
_____B___B
__B__P_B_P
_______PWB
WWWWWWWWWW
