WWWWW_B___
______P___
_BPB_BW___
_PBWBWW___
BBW_W___P_
PW__WD_BWB
WWWWWWWWWW
