WWWWW_____
______P___
_____BW___
_PBW_WW_B_
_BW_W___P_
BW__WD_PWB
WWWWWWWWWW
