WWWWW_B___
______P___
_B____W___
_P_W_WW__B
_BW_W____P
_W__WDP_WB
WWWWWWWWWW
