PW_WW___B_
BWPW______
WWWW______
W____B____
___B__W___
___BB_WPB_
WWWWWWWWWW
