W___..___W
W________W
W________W
W________W
W________W
W________W
W________W
.....____W
.....____W
......WWWW
