._._._._..
._._._._WW
._._W_.___
W_.___....
__........
....W..W.B
WWWWWWWWWW
