_B__B_____
____P___WW
____W_____
W_____B__B
__B_B_P__P
P_P_W__WBB
WWWWWWWWWW
