___B_____B
_B_P__B_WW
_P__W_____
W_________
______P__P
__PBW__W_B
WWWWWWWWWW
