________
_D__D___
_P______
________
________
_P___P__
_D______
________