__________
__________
__________
__________
__B______.
.BW_W.....
..........
