WWWWWWWW
WWWWWWWW
WWD___WW
WW____WW
WW___PWW
WW____WW
WWP__DWW
WWWWWWWW