WWWWWWWW
WWWWWWWW
WWD___WW
WW____WW
WWP___WW
WW___PWW
WW___DWW
WWWWWWWW