WWW_______
_________B
_________P
___B_____W
___PB_B_BW
BPB_BBWBBW
WWWWWWWWWW
