WWW_______
__________
__________
___B_B___W
_B__BPB_BW
_PBPBBWBBW
WWWWWWWWWW
