W W W W W W
W _ _ _ O W
W _ _ B _ W
W O W _ _ W
W _ W B _ W
W P _ _ _ W
W W W W W W