W W W W W W
W _ _ _ G W
W _ _ _ _ W
W O W _ P W
W _ W B _ W
W _ _ _ _ W
W W W W W W