W W W W W W
W _ _ _ G W
W _ _ _ _ W
W O W _ _ W
W _ W B _ W
W _ _ _ P W
W W W W W W