W W W W W W
W _ _ _ G W
W _ _ B _ W
W O W _ P W
W _ W _ _ W
W _ _ _ _ W
W W W W W W