W W W W W W
W _ _ _ G W
W _ _ B P W
W O W _ _ W
W _ W _ _ W
W _ _ _ _ W
W W W W W W