W W W W W W
W _ P _ G W
W B _ _ _ W
W O W _ _ W
W _ W _ _ W
W _ _ _ _ W
W W W W W W