W W W W W W
W _ _ _ G W
W P _ _ _ W
W G W _ _ W
W _ W _ _ W
W _ _ _ _ W
W W W W W W