_WWD__WP__
__WW__W___
___W_PW___
____W_W___
_B__W_WPB_
_WBWWDW_BP
WWWWWWWWWW
