_____W____
____W_W___
___W___W__
__W_____W_
_W_______W
W________W
W________W
W________W
W___BP___W
WWW.WWWWWW
