_____W____
____W_W___
___W___W__
__W_____W_
_W_______W
W________W
W___...__W
W__....__W
W__....__W
WWW....WWW
