____WW_W__
______W___
B_________
P___P___B_
WB__WB__P_
WB_BWB_B_W
WWWWWWWWWW
