____WW_W__
______W___
__________
___P____B_
WB__WB____
WB_BWB_BPW
WWWWWWWWWW
