B___WW_W__
P_____W___
__________
__________
WB__WB____
WBPBWB_B_W
WWWWWWWWWW
