W___...._W
W___.P.._W
W__....._W
W________W
W________W
W___W_B__W
WWWWWWWWWW
