W___...._W
W___._.._W
W__.WWW._W
W________W
W________W
W___W_B__W
WWWWWWWWWW
