W___W.W__W
W___W_W__W
W___W.W__W
W________W
W____W___W
W____WB__W
WWWWWWWWWW
