________
_D___D__
_P______
________
____P___
________
________
________