___W_WWW__
_B_____W__
_P__B_____
_W__P___B_
_W______P_
_W_____BWB
WWWWWWWWWW
