___W______
___D_P_B_B
___WWW_B_P
_______WBW
__B_B__WW_
D_WB__PWD_
WWWWWWWWWW
