___W___P__
___D___B__
___WWW_B__
_______WBW
__B___BWW_
D_WBB_PWD_
WWWWWWWWWW
