XXXXXXXXXX
XXXXXXXXXX
XXXXXXXXXX
XXXXXXXXXX
XXXXPXXXXX
XXXX.XXXXX
WWWWWWWWWW
