WWWWWW
WWWWWW
W__PDW
W____W
W____W
WWWWWW