_ _ _ _ _ _ _ _
_ D _ _ _ _ _ _
_ _ _ P _ _ P _
_ _ _ _ _ _ _ _
_ _ _ _ _ _ _ _
_ D _ _ _ D _ _
_ _ P _ _ _ _ _
_ _ _ _ _ _ _ _

***

_ _ _ _ _ _ _ _
_ D _ _ _ _ _ _
_ _ P _ _ _ P _
_ _ _ _ _ _ _ _
_ _ _ _ _ _ _ _
_ D _ _ _ D _ _
_ P _ _ _ _ _ _
_ _ _ _ _ _ _ _

***

_ _ _ _ _ _ _ _
_ D _ _ _ _ _ _
_ P _ _ _ P _ _
_ _ _ _ _ _ _ _
_ _ _ _ _ _ _ _
_ D _ _ _ D _ _
_ P _ _ _ _ _ _
_ _ _ _ _ _ _ _

***

_ _ _ _ _ _ _ _
_ D _ _ _ _ _ _
_ P _ _ P _ _ _
_ _ _ _ _ _ _ _
_ _ _ _ _ _ _ _
_ D _ _ _ D _ _
_ P _ _ _ _ _ _
_ _ _ _ _ _ _ _

***

_ _ _ _ _ _ _ _
_ D _ _ _ _ _ _
_ P _ _ P _ _ _
_ _ _ _ _ _ _ _
_ _ _ _ _ _ _ _
_ D _ _ _ D _ _
_ P _ _ _ _ _ _
_ _ _ _ _ _ _ _

***

_ _ _ _ _ _ _ _
_ D _ _ _ _ _ _
_ P _ _ _ P _ _
_ _ _ _ _ _ _ _
_ _ _ _ _ _ _ _
_ D _ _ _ D _ _
_ P _ _ _ _ _ _
_ _ _ _ _ _ _ _

***

_ _ _ _ _ _ _ _
_ D _ _ _ _ _ _
_ P _ _ P _ _ _
_ _ _ _ _ _ _ _
_ _ _ _ _ _ _ _
_ D _ _ _ D _ _
_ P _ _ _ _ _ _
_ _ _ _ _ _ _ _

***

_ _ _ _ _ _ _ _
_ D _ _ _ _ _ _
_ P _ _ _ _ _ _
_ _ _ _ P _ _ _
_ _ _ _ _ _ _ _
_ D _ _ _ D _ _
_ P _ _ _ _ _ _
_ _ _ _ _ _ _ _

***

_ _ _ _ _ _ _ _
_ D _ _ _ _ _ _
_ P _ _ _ _ _ _
_ _ _ _ _ _ _ _
_ _ _ _ P _ _ _
_ D _ _ _ D _ _
_ P _ _ _ _ _ _
_ _ _ _ _ _ _ _

***

_ _ _ _ _ _ _ _
_ D _ _ _ _ _ _
_ P _ _ _ _ _ _
_ _ _ _ _ _ _ _
_ _ _ _ _ _ _ _
_ D _ _ P D _ _
_ P _ _ _ _ _ _
_ _ _ _ _ _ _ _

***

T T T T T T T T
T T T T T T T T
T T T T T T T T
T T T T T T T T
T T T T T T T T
T T T T T T T T
T T T T T T T T
T T T T T T T T

***

