______....
________.W
__WWWWWWW_
_W________
W________.
W__W__W__W
WWWWWWWWWW
