__________
__________
__B_______
_PB______P
_BBPB_B___
BBBWBBPBB_
WWWWWWWWWW
