________
_D__D___
_P______
_____P__
________
_P______
_D______
________