________
_D__DP__
_P______
________
________
_P______
_D______
________