WWWWW__PWW
_______WW_
B_____W___
P___WWW___
_B_W_____B
WB_WPWDWPB
WWWWWWWWWW
