__P_B___B_
B___P_P___
W_________
_WWWW_____
_W_____B__
DW____PWPB
WWWWWWWWWW
