WWWWWW
WWD__W
WW___W
WW___W
WWP__W
WWWWWW