__________
___B______
___BBP____
_WWWWWWWW_
W________W
W________W
WWWWWWWWWW
