__..______
__..______
__..B_____
_WWWWWWWW_
W________W
W________W
WWWWWWWWWW
