W__...__W_
W_______W_
W_______W.
W._______W
...______W
W__W__W__W
WWWWWWWWWW
