__BW_P_P__
___WW_____
_______B__
_B________
___P__B__W
BP___WPB_W
WWWWWWWWWW
