W__....__W
W________W
W________W
W________W
W_____P__W
W__W_....W
WWWWWWWWWW
