BW_B_B__W_
W_WWBPW_WB
___WWWW__W
__________
_BP_B_P___
BBBBB__W_D
WWWWWWWWWW
