B_____P__B
__B__WWW_P
PB_______W
_B_______W
BBP______W
PB__B___DW
WWWWWWWWWW
