___B______
B__P______
BB_WBB____
WWWWWWBP_W
_____WBB_W
_P___WWWBW
WWWWWWWWWW
