__B_______
B_P_______
BB_WBBP___
WWWWWWB__W
_____WBB_W
__P__WWWBW
WWWWWWWWWW
