_______P__
__B____W__
_B__P_____
WWWWB_P___
___WW_W___
__DWD_D__B
WWWWWWWWWW
