____B__P_B
_______W__
BBB_______
WWWWB_P___
___WW_W___
__DWD_D__B
WWWWWWWWWW
