_________
_________
_________
____W____
_BH_W__O_
_WWWWWWW_
WWWWWWWWW