________
________
________
_D___P__
________
________
____PD__
________