________
________
________
_DP_____
________
________
____PD__
________