WB_____B__
WW_______P
__________
______B_P_
___P____B_
__B__B__W_
WWWWWWWWWW
