WB_P______
WW___B___P
_______B__
___B_____P
_B_P____B_
BPB__BB_WB
WWWWWWWWWW
