__W_______
_W________
_W________
W_________
W_________
W____P__DW
WWWWWWWWWW
