____B_____
_B__P____B
___WW_____
______B___
____W_P_W_
BP__WBB_WB
WWWWWWWWWW
