__P_______
P___B_____
____P_____
____W____B
____W____W
_B__D_D_DW
WWWWWWWWWW
