__P_______
P_________
__________
____W____B
____W____W
_BP_D_D_DW
WWWWWWWWWW
