P_________
__B_______
P_P_P___B_
____W_B_PB
____W____W
P___D_DPDW
WWWWWWWWWW
