WWW_W_____
___WW_P___
______W___
______W___
__B_B_____
B_B_B__BB_
WWWWWWWWWW
