WWW_W___P_
___WW_____
_P____W___
______W___
__BPB_____
B_B_BB___B
WWWWWWWWWW
