W__....__W
W________W
W________W
W________W
W___P____W
W__...__DW
WWWWWWWWWW
