___B___P_P
___W___WWW
_B_W___W_W
____WP____
_P_BW___P_
_W_WWBB_B_
WWWWWWWWWW
