_______BP_
_P_W___WWW
___W___W_W
____WB____
_P__WP__P_
BWBWWBB_B_
WWWWWWWWWW
