__________
_WW_______
______P___
__________
__BBP_____
__BBW_D_B_
WWWWWWWWWW
