_B________
_WW_______
____P_____
______P__B
__B_P_____
__BBW_D_BP
WWWWWWWWWW
