_BP_______
_WW_______
____P_____
______P___
_BB______B
__BBW_D__P
WWWWWWWWWW
