__W______W
_W_______W
W________W
W___.____W
W___W____W
W__BW____W
WWWWWWWWWW
