____P_____
_______P_W
____B__B__
_B__P__P_P
PW__W____W
BW_PW_B_DW
WWWWWWWWWW
