P_P_P__P__
_________W
B_B_B_____
B___P__PB_
PW__WB__PW
BW_PWP__DW
WWWWWWWWWW
