W W W W W W W
W _ _ _ P _ W
W _ W _ W _ W
W W W _ W D W
W _ _ _ W W W
W _ W W W _ W
W _ _ _ _ _ W
W W W W W W W