__________
_WWWWWWWW_
W________W
W________W
W___B____W
W___P___DW
WWWWWW.WWW
