_ _ _ _ _ _
_ _ _ _ _ _
_ _ _ P _ _
_ O _ B _ _
_ _ _ _ _ _
_ _ _ _ _ _