______________________
______________________
______________________
______________________
______________________
___BBB__BBB__BBBBB____
___VWB__BWV__VWBVBH___
_BBVWBBBBWVBBVWBVW__O_
_WWWWWWWWWWWWWWWWWWWW_
WWWWWWWWWWWWWWWWWWWWWW