W__________________W
W__________________W
W__________________W
W___W____P__W______W
WD__W___W_B_WB_____W
WWWWWWWWWWWWWWWWWWWW