W__________________W
W__________________W
W______B___________W
W___W_______W______W
WD__W__PW___WB_____W
WWWWWWWWWWWWWWWWWWWW