W__________________W
W__________________W
W__________________W
W___W_______W______W
WD__W___W_BPWB_____W
WWWWWWWWWWWWWWWWWWWW