W__________________W
W__________________W
W__________________W
W___WP______W______W
WD__WB__W___WB_____W
WWWWWWWWWWWWWWWWWWWW