W__________________W
W__________________W
W__________________W
W___W_______W______W
WD__W___W_B_W_B_P__W
WWWWWWWWWWWWWWWWWWWW