_ _ _ _ _ _ _ _ _ _ _ _ _ _ _ _ _
_ _ _ _ _ _ _ _ _ _ _ _ _ _ _ _ _
_ _ _ _ _ _ _ _ _ _ _ _ _ _ _ _ _
_ _ _ _ _ _ W _ _ _ _ _ W _ _ _ _
_ _ _ _ _ B W _ _ _ _ B W _ _ _ _
_ _ _ _ B B W _ _ _ B B W _ _ G _
_ W W W W W W W W W W W W W W W _
W W W W W W W W W W W W W W W W W