_______WW_
_______WW_
____B____W
___BPB____
__BPBB_B__
_BBWBBBBBP
WWWWWWWWWW
