_______WW_
_______WW_
_B_B_____W
_P_P_B____
__B_BB____
BBBWBBBPBB
WWWWWWWWWW
