_ _ _ _ _ _ _ _ _ _ _ _ _ _ _ _ _
_ _ _ _ _ _ _ _ _ _ _ _ _ _ _ _ _
_ _ _ _ _ _ _ _ _ _ _ _ _ _ _ _ _
_ _ _ _ _ _ _ B _ _ _ _ W _ _ _ _
_ _ _ _ _ _ _ P W _ _ B W _ _ _ _
_ _ _ _ _ _ _ B W _ _ B W _ _ O _
_ W W W W W W W W W W W W W W W _
W W W W W W W W W W W W W W W W W