__________
_____P____
B___WWWB_B
W_____WB_P
W_____WWB_
W__B__DWBB
WWWWWWWWWW
