__________
____P_____
B___WWWB_B
W_____WB__
W_B___WWBP
W_P___DWBB
WWWWWWWWWW
