_W________
_W________
__________
__________
B___B___BB
P_B__W_WPW
WWWWWWWWWW
