_W________
_W________
__________
_P_P______
_____B_B__
B_BP_WPWPW
WWWWWWWWWW
