_ _ _ _ _ _ _ _
_ _ _ _ _ _ _ _
_ _ _ _ D P _ _
_ _ _ _ _ _ _ _
_ _ _ _ _ _ _ _
_ _ _ D P _ _ _
_ _ _ _ _ _ _ _
_ _ _ _ _ _ _ _

***

_ _ _ _ _ _ _ _
_ _ _ _ _ _ _ _
_ _ _ _ D P _ _
_ _ _ _ _ _ _ _
_ _ _ _ _ _ _ _
_ _ _ D P _ _ _
_ _ _ _ _ _ _ _
_ _ _ _ _ _ _ _

***

_ _ _ _ _ _ _ _
_ _ _ _ _ _ _ _
_ _ _ _ D P _ _
_ _ _ _ _ _ _ _
_ _ _ _ _ _ _ _
_ _ _ D P _ _ _
_ _ _ _ _ _ _ _
_ _ _ _ _ _ _ _

***

_ _ _ _ _ _ _ _
_ _ _ _ _ _ _ _
_ _ _ _ D P _ _
_ _ _ _ _ _ _ _
_ _ _ _ _ _ _ _
_ _ _ D P _ _ _
_ _ _ _ _ _ _ _
_ _ _ _ _ _ _ _

***

_ _ _ _ _ _ _ _
_ _ _ _ _ _ _ _
_ _ _ _ D P _ _
_ _ _ _ _ _ _ _
_ _ _ _ _ _ _ _
_ _ _ D P _ _ _
_ _ _ _ _ _ _ _
_ _ _ _ _ _ _ _

***

_ _ _ _ _ _ _ _
_ _ _ _ _ _ _ _
_ _ _ _ D P _ _
_ _ _ _ _ _ _ _
_ _ _ _ _ _ _ _
_ _ _ D P _ _ _
_ _ _ _ _ _ _ _
_ _ _ _ _ _ _ _

***

T T T T T T T T
T T T T T T T T
T T T T T T T T
T T T T T T T T
T T T T T T T T
T T T T T T T T
T T T T T T T T
T T T T T T T T

***

