W_WWW__WWW
_W________
__________
_________B
PB___P_W_P
_BB_B_BW_B
WWWWWWWWWW
