__________
__________
__________
__________
._____B_._
..P.W_WB..
WWWWWWWWWW
