__________
__________
__________
__________
._____B_._
....W_WB..
..........
