PB________
W____BPW__
W____WWW__
____W_____
_B_WW___B_
PBBWD_P_W_
WWWWWWWWWW
