P_____B___
WB_P__PWP_
W____WWW__
____W_____
_BBWW_____
_BBWDP__W_
WWWWWWWWWW
