_P___P____
__________
_____B_P_B
D____P_B_W
W______P__
WB_DWW_BB_
WWWWWWWWWW
