_____P____
_P________
_______P__
D____P_B_W
W______P__
WB_DWW_BBP
WWWWWWWWWW
