______..__
__________
___W_____.
___WB_.___
_WWWWWWWW_
W________W
W________W
W________W
W__W__W__W
WWWWWWWWWW
