________
_P______
_____D__
________
_D______
________
______P_
________