__________
__________
__________
__________
__________
....P.....
WWWWWWWWWW
