_B___WW___
_P________
__B_______
__BB_P____
__WW_B__B_
__DWWWWBB_
WWWWWWWWWW
