____________
____________
____________
____________
____________
____________
____________
____________
____________
_H________O_
_WWWWWWWWWW_
WWWWWWWWWWWW