__________
__________
__________
_________P
_______B_W
_BP_DWBP_W
WWWWWWWWWW
