__________
__________
__________
__________
_________W
__P_DWBPBW
WWWWWWWWWW
