___P______
B_________
P_________
_______B_B
B________W
P___DWBP_W
WWWWWWWWWW
