WB__WW____
WW___W____
_W________
______B___
P_PW_BPB__
BBBWBBBW_B
WWWWWWWWWW
