WB__WW____
WW___W____
_W________
____P_____
___W_B_B__
BBBWBBBW__
WWWWWWWWWW
