W___WW____
WW___W____
_W________
_________P
___WPBPB__
_B_WBBBW__
WWWWWWWWWW
