WWWWW
W___W
WDW_W
WWW_W
WP__W
WWWWW
     
WWWWW
W___W
WDW_W
WWW_W
W_P_W
WWWWW
     
WWWWW
W___W
WDW_W
WWW_W
W__PW
WWWWW
     
WWWWW
W___W
WDW_W
WWWPW
W___W
WWWWW
     
WWWWW
W___W
WDWPW
WWW_W
W___W
WWWWW
     
WWWWW
W__PW
WDW_W
WWW_W
W___W
WWWWW
     
WWWWW
W_P_W
WDW_W
WWW_W
W___W
WWWWW
     
WWWWW
WP__W
WDW_W
WWW_W
W___W
WWWWW
     
WWWWW
W___W
WXW_W
WWW_W
W___W
WWWWW
     
WWWWW
W___W
WXW_W
WWW_W
W___W
WWWWW
     
WWWWW
W___W
WXW_W
WWW_W
W___W
WWWWW
     
WWWWW
W___W
WXW_W
WWW_W
W___W
WWWWW
     
WWWWW
W___W
WXW_W
WWW_W
W___W
WWWWW