.WW.WWWWWW
.__.______
.__.__P__W
..........
__________
W_____P__W
WWWWWWWWWW
