.WWWWWWWWW
._________
.P_D_P___W
.WW.......
__________
W____.___W
WWWWWWWWWW
