_______W__
__________
__________
B___P_____
P___W__B_B
WB_BW_BW_P
WWWWWWWWWW
