_______W__
__________
__________
____P_____
PB__W__B__
WB_BW_BW__
WWWWWWWWWW
