WWWWWWWW
WW_____W
WWWWWWWW
WWWWWWWW
WW_DW_WW
WW_WW_WW
WW__P_WW
WWWWWWWW