WWWWWWWW
WW_____W
WWWWWWWW
WWWWWWWW
WW_DW_WW
WWPWW_WW
WW____WW
WWWWWWWW