__WBW_W___
__WW__W___
__________
________B_
_B_P_B__PB
WB_W_BPWBB
WWWWWWWWWW
