__WBW_W___
__WW__W___
B_________
P___B__B__
__P__B_P_B
W__WPB_WBB
WWWWWWWWWW
