WWWWWW
W_DW_W
WPWW_W
W____W
WWWWWW
WWWWWW