WWWWWWWW
WWWWWWWW
WW___DWW
WWP___WW
WW____WW
WW____WW
WWWWWWWW
WWWWWWWW