_____WBWW_
_B_P_WBW_W
______W___
____B_____
_B_____B__
_PBBPBBBBW
WWWWWWWWWW
