__P___D_WW
D_____WW__
W________B
__D_____BP
__WWWBP_WW
_WWDW_B_DW
WWWWWWWWWW
