..........___W_.....
..........__DW__....
..........WWWW______
..........__________
............___P_B_W
.............._._PBW
WWWWWWWWWWWWWWWWWWWW
