. . . . . .
. . . . . .
. . . . . .
. . . P . .
. . D . . .
. . . . . .