__________
_______P__
_P_B______
_B_____B__
_P_____P_B
BWBB__B_WP
WWWWWWWWWW
