P_________
__________
_______P__
_B_B___B__
_P_____P__
BWB__BB_W_
WWWWWWWWWW
