______P___
P_P_P___B_
______B_P_
__________
BP_B_B____
_W_P____W_
WWWWWWWWWW
