__________
__P_______
____B____B
___PB_____
__BBW___B_
D_PW___BBW
WWWWWWWWWW
