__BW_W_W_W
DWWW__WW__
WW________
_______P__
__________
BB__BWPB_P
WWWWWWWWWW
