__________
__________
__________
__________
__________
.__.P.....
..........
