__WW___B__
_______W__
____P__W__
_P__W_____
___BW_B_BP
BBBBWBBBBW
WWWWWWWWWW
