__WW______
_______W__
_______W__
B___WP____
P_PBW_B___
BBBBWBB_BW
WWWWWWWWWW
