_B________
___B______
___WB_____
___WW__B__
_W____WW__
PWBBB_DW__
WWWWWWWWWW
