__________
_P____B__B
_B_W______
_P_WW_PB__
_W____WW__
_WB_P_DWB_
WWWWWWWWWW
