________
__P_____
_____D__
________
_D______
____P___
________
________