______________________
______________________
______________________
______________________
______________________
__BBBB__BBB___________
__VBWB__VWB___________
_BBVWBBBVWBBBBH_____O_
_WWWWWWWWWWWWWWWWWWWW_
WWWWWWWWWWWWWWWWWWWWWW