W__....__W
W________W
W________W
W________W
W________W
W_.B_P__DW
WWWWWWWWWW
