W__....__W
W________W
W________W
W________W
W________W
W__BP___DW
WWWWWWWWWW
