W__....__W
W________W
W________W
W___.____W
W__...___W
W__...___W
WWW...WWWW
