__________
_____W____
__________
__BP_BP___
___W__BW__
BB_W__BWB_
WWWWWWWWWW
