_B___P____
_P___W____
__________
___P__P___
__BW_BBW_B
_B_W_PBWBP
WWWWWWWWWW
