_B__BP___B
_P___W_P_P
__________
___PB___P_
B__W___W_B
__BW_BBWBP
WWWWWWWWWW
