________
_D__PD__
_P______
________
____D___
___P____
________
________