____WW____
______W___
_______W__
________W_
_________W
_________W
.________W
.____W___W
._PB_W__DW
.WWWWWWWWW
