__________
__________
______D___
______P___
__________
__DP______
__________
______PD__
__________
__________