__________
__________
__________
__________
____P_____
.__.......
WWWWWWWWWW
