__WW_WW___
______W___
____B_____
__P_W__B__
B__BWBB_BB
PBWBWPWPBP
WWWWWWWWWW
