__WW_WW___
B_____W_B_
P_________
__B_W_____
B_P_WBB_B_
PBWBWPW_BB
WWWWWWWWWW
