______B__W
W_PW__B___
W_WW__W___
WWWW__W_P_
______W_B_
_WDW_DPBBW
WWWWWWWWWW
