___P_BB__W
W__W__B___
WPWW__W___
WWWW__W_P_
______W_B_
_WDW_DWBBW
WWWWWWWWWW
