________
__P_____
_____P__
________
____D___
________
_D______
________