______W_WB
_______WWB
________WW
____B_____
____PWB___
P_D_WWWP__
WWWWWWWWWW
