__WW_W__WW
WWW__D____
_____W____
_____W_B__
___B___WBP
P__P_B_WBB
WWWWWWWWWW
