__WW_W__WW
WWW__D____
_____W____
_____W_B__
_______WB_
_P_P___WBB
WWWWWWWWWW
