P_B______P
BWW______B
W______B_P
__B____B__
__BPB_BWW_
P_WBB_PWD_
WWWWWWWWWW
