__________
__________
____D__P__
_______D__
__________
__________
___P______
______DP__
__________
__________