__________
__________
____D__P__
___P___D__
__________
__________
__________
______DP__
__________
__________