____B_W_B_
____P_W_P_
__B_B_____
W___W___B_
______B___
_B_WBBBB__
WWWWWWWWWW
