P____PW_B_
__P___W___
P_______P_
W___W_____
__B___B___
__PWB_BBP_
WWWWWWWWWW
