_ _ _ _ _ _
_ _ P _ _ _
_ _ B _ _ _
_ _ _ _ O _
_ _ _ _ _ _
_ _ _ _ _ _

***

_ _ _ _ _ _
_ _ _ _ _ _
_ _ P _ _ _
_ _ B _ O _
_ _ _ _ _ _
_ _ _ _ _ _

***

_ _ _ _ _ _
_ _ _ _ _ _
_ P _ _ _ _
_ _ B _ O _
_ _ _ _ _ _
_ _ _ _ _ _

***

_ _ _ _ _ _
_ _ _ _ _ _
_ _ _ _ _ _
_ P B _ O _
_ _ _ _ _ _
_ _ _ _ _ _

***

_ _ _ _ _ _
_ _ _ _ _ _
_ _ _ _ _ _
_ _ P B O _
_ _ _ _ _ _
_ _ _ _ _ _

***

_ _ _ _ _ _
_ _ _ _ _ _
_ _ _ _ _ _
_ _ _ P G _
_ _ _ _ _ _
_ _ _ _ _ _

***

T T T T T T
T T T T T T
T T T T T T
T T T T T T
T T T T T T
T T T T T T

***

