WWWWWWWWWWWW
W_WW___W_W_W
WWWWWW___WWW
WWW______W_W
WWW__WW____W
W__W_______W
WW__WW____WW
W___WW___W_W
WWW____O___W
W___WOBBW__W
WWW_WWOBPWWW
WWWWWWWWWWWW
            
WWWWWWWWWWWW
W_WW___W_W_W
WWWWWW___WWW
WWW______W_W
WWW__WW____W
W__W_______W
WW__WW____WW
W___WW___W_W
WWW____O___W
W___WOBBW__W
WWW_WWGP_WWW
WWWWWWWWWWWW
            
WWWWWWWWWWWW
W_WW___W_W_W
WWWWWW___WWW
WWW______W_W
WWW__WW____W
W__W_______W
WW__WW____WW
W___WW___W_W
WWW____G___W
W___WOBPW__W
WWW_WWG__WWW
WWWWWWWWWWWW
            
WWWWWWWWWWWW
W_WW___W_W_W
WWWWWW___WWW
WWW______W_W
WWW__WW____W
W__W_______W
WW__WW____WW
W___WW___W_W
WWW____G___W
W___WGP_W__W
WWW_WWG__WWW
WWWWWWWWWWWW
            
WWWWWWWWWWWW
W_WW___W_W_W
WWWWWW___WWW
WWW______W_W
WWW__WW____W
W__W_______W
WW__WW____WW
W___WW___W_W
WWW____G___W
W___WG_PW__W
WWW_WWG__WWW
WWWWWWWWWWWW
            
WWWWWWWWWWWW
W_WW___W_W_W
WWWWWW___WWW
WWW______W_W
WWW__WW____W
W__W_______W
WW__WW____WW
W___WW___W_W
WWW____G___W
W___WG__W__W
WWW_WWGP_WWW
WWWWWWWWWWWW
            
WWWWWWWWWWWW
W_WW___W_W_W
WWWWWW___WWW
WWW______W_W
WWW__WW____W
W__W_______W
WW__WW____WW
W___WW___W_W
WWW____G___W
W___WG__W__W
WWW_WWG_PWWW
WWWWWWWWWWWW
            
WWWWWWWWWWWW
W_WW___W_W_W
WWWWWW___WWW
WWW______W_W
WWW__WW____W
W__W_______W
WW__WW____WW
W___WW___W_W
WWW____G___W
W___WG__W__W
WWW_WWG_PWWW
WWWWWWWWWWWW
            
WWWWWWWWWWWW
W_WW___W_W_W
WWWWWW___WWW
WWW______W_W
WWW__WW____W
W__W_______W
WW__WW____WW
W___WW___W_W
WWW____G___W
W___WG__W__W
WWW_WWGP_WWW
WWWWWWWWWWWW
            
WWWWWWWWWWWW
W_WW___W_W_W
WWWWWW___WWW
WWW______W_W
WWW__WW____W
W__W_______W
WW__WW____WW
W___WW___W_W
WWW____G___W
W___WG__W__W
WWW_WWGP_WWW
WWWWWWWWWWWW
            
WWWWWWWWWWWW
W_WW___W_W_W
WWWWWW___WWW
WWW______W_W
WWW__WW____W
W__W_______W
WW__WW____WW
W___WW___W_W
WWW____G___W
W___WG_PW__W
WWW_WWG__WWW
WWWWWWWWWWWW
            
WWWWWWWWWWWW
W_WW___W_W_W
WWWWWW___WWW
WWW______W_W
WWW__WW____W
W__W_______W
WW__WW____WW
W___WW___W_W
WWW____G___W
W___WGP_W__W
WWW_WWG__WWW
WWWWWWWWWWWW
            
WWWWWWWWWWWW
W_WW___W_W_W
WWWWWW___WWW
WWW______W_W
WWW__WW____W
W__W_______W
WW__WW____WW
W___WW___W_W
WWW___PG___W
W___WG__W__W
WWW_WWG__WWW
WWWWWWWWWWWW
            
WWWWWWWWWWWW
W_WW___W_W_W
WWWWWW___WWW
WWW______W_W
WWW__WW____W
W__W_______W
WW__WW____WW
W___WW___W_W
WWW___PG___W
W___WG__W__W
WWW_WWG__WWW
WWWWWWWWWWWW
            
WWWWWWWWWWWW
W_WW___W_W_W
WWWWWW___WWW
WWW______W_W
WWW__WW____W
W__W_______W
WW__WW____WW
W___WW___W_W
WWW___PG___W
W___WG__W__W
WWW_WWG__WWW
WWWWWWWWWWWW
            
WWWWWWWWWWWW
W_WW___W_W_W
WWWWWW___WWW
WWW______W_W
WWW__WW____W
W__W_______W
WW__WW____WW
W___WWP__W_W
WWW____G___W
W___WG__W__W
WWW_WWG__WWW
WWWWWWWWWWWW
            
WWWWWWWWWWWW
W_WW___W_W_W
WWWWWW___WWW
WWW______W_W
WWW__WW____W
W__W_______W
WW__WW____WW
W___WW_P_W_W
WWW____G___W
W___WG__W__W
WWW_WWG__WWW
WWWWWWWWWWWW
            
WWWWWWWWWWWW
W_WW___W_W_W
WWWWWW___WWW
WWW______W_W
WWW__WW____W
W__W_______W
WW__WW____WW
W___WW__PW_W
WWW____G___W
W___WG__W__W
WWW_WWG__WWW
WWWWWWWWWWWW
            
WWWWWWWWWWWW
W_WW___W_W_W
WWWWWW___WWW
WWW______W_W
WWW__WW____W
W__W_______W
WW__WW____WW
W___WW__PW_W
WWW____G___W
W___WG__W__W
WWW_WWG__WWW
WWWWWWWWWWWW
            
WWWWWWWWWWWW
W_WW___W_W_W
WWWWWW___WWW
WWW______W_W
WWW__WW____W
W__W_______W
WW__WW____WW
W___WW___W_W
WWW____GP__W
W___WG__W__W
WWW_WWG__WWW
WWWWWWWWWWWW
META {"type": "solver", "id": "pysat-gluecard41", "objective": 0}
