WWWWWWWWWWWW
WWWWW____O_W
W_____W__BWW
WW____W____W
W_WW_W__PBOW
WWWW_WWOB_WW
WWWW__W_WW_W
WWWW__WWWWWW
WW_WW_____WW
WWW_W_WW__WW
W__WW_WWWWWW
WWWWWWWWWWWW
            
WWWWWWWWWWWW
WWWWW____O_W
W_____W__BWW
WW____W____W
W_WW_W___PGW
WWWW_WWOB_WW
WWWW__W_WW_W
WWWW__WWWWWW
WW_WW_____WW
WWW_W_WW__WW
W__WW_WWWWWW
WWWWWWWWWWWW
            
WWWWWWWWWWWW
WWWWW____O_W
W_____W__BWW
WW____W__P_W
W_WW_W____GW
WWWW_WWOB_WW
WWWW__W_WW_W
WWWW__WWWWWW
WW_WW_____WW
WWW_W_WW__WW
W__WW_WWWWWW
WWWWWWWWWWWW
            
WWWWWWWWWWWW
WWWWW____G_W
W_____W__PWW
WW____W____W
W_WW_W____GW
WWWW_WWOB_WW
WWWW__W_WW_W
WWWW__WWWWWW
WW_WW_____WW
WWW_W_WW__WW
W__WW_WWWWWW
WWWWWWWWWWWW
            
WWWWWWWWWWWW
WWWWW____G_W
W_____W___WW
WW____W__P_W
W_WW_W____GW
WWWW_WWOB_WW
WWWW__W_WW_W
WWWW__WWWWWW
WW_WW_____WW
WWW_W_WW__WW
W__WW_WWWWWW
WWWWWWWWWWWW
            
WWWWWWWWWWWW
WWWWW____G_W
W_____W___WW
WW____W_P__W
W_WW_W____GW
WWWW_WWOB_WW
WWWW__W_WW_W
WWWW__WWWWWW
WW_WW_____WW
WWW_W_WW__WW
W__WW_WWWWWW
WWWWWWWWWWWW
            
WWWWWWWWWWWW
WWWWW____G_W
W_____W___WW
WW____WP___W
W_WW_W____GW
WWWW_WWOB_WW
WWWW__W_WW_W
WWWW__WWWWWW
WW_WW_____WW
WWW_W_WW__WW
W__WW_WWWWWW
WWWWWWWWWWWW
            
WWWWWWWWWWWW
WWWWW____G_W
W_____W___WW
WW____W____W
W_WW_W_P__GW
WWWW_WWOB_WW
WWWW__W_WW_W
WWWW__WWWWWW
WW_WW_____WW
WWW_W_WW__WW
W__WW_WWWWWW
WWWWWWWWWWWW
            
WWWWWWWWWWWW
WWWWW____G_W
W_____W___WW
WW____W____W
W_WW_W____GW
WWWW_WWQB_WW
WWWW__W_WW_W
WWWW__WWWWWW
WW_WW_____WW
WWW_W_WW__WW
W__WW_WWWWWW
WWWWWWWWWWWW
            
WWWWWWWWWWWW
WWWWW____G_W
W_____W___WW
WW____W____W
W_WW_W____GW
WWWW_WWOB_WW
WWWW__WPWW_W
WWWW__WWWWWW
WW_WW_____WW
WWW_W_WW__WW
W__WW_WWWWWW
WWWWWWWWWWWW
            
WWWWWWWWWWWW
WWWWW____G_W
W_____W___WW
WW____W____W
W_WW_W____GW
WWWW_WWQB_WW
WWWW__W_WW_W
WWWW__WWWWWW
WW_WW_____WW
WWW_W_WW__WW
W__WW_WWWWWW
WWWWWWWWWWWW
            
WWWWWWWWWWWW
WWWWW____G_W
W_____W___WW
WW____W____W
W_WW_W_P__GW
WWWW_WWOB_WW
WWWW__W_WW_W
WWWW__WWWWWW
WW_WW_____WW
WWW_W_WW__WW
W__WW_WWWWWW
WWWWWWWWWWWW
            
WWWWWWWWWWWW
WWWWW____G_W
W_____W___WW
WW____WP___W
W_WW_W____GW
WWWW_WWOB_WW
WWWW__W_WW_W
WWWW__WWWWWW
WW_WW_____WW
WWW_W_WW__WW
W__WW_WWWWWW
WWWWWWWWWWWW
            
WWWWWWWWWWWW
WWWWW____G_W
W_____W___WW
WW____W_P__W
W_WW_W____GW
WWWW_WWOB_WW
WWWW__W_WW_W
WWWW__WWWWWW
WW_WW_____WW
WWW_W_WW__WW
W__WW_WWWWWW
WWWWWWWWWWWW
            
WWWWWWWWWWWW
WWWWW____G_W
W_____W___WW
WW____W__P_W
W_WW_W____GW
WWWW_WWOB_WW
WWWW__W_WW_W
WWWW__WWWWWW
WW_WW_____WW
WWW_W_WW__WW
W__WW_WWWWWW
WWWWWWWWWWWW
            
WWWWWWWWWWWW
WWWWW____G_W
W_____W___WW
WW____W____W
W_WW_W___PGW
WWWW_WWOB_WW
WWWW__W_WW_W
WWWW__WWWWWW
WW_WW_____WW
WWW_W_WW__WW
W__WW_WWWWWW
WWWWWWWWWWWW
            
WWWWWWWWWWWW
WWWWW____G_W
W_____W___WW
WW____W____W
W_WW_W____GW
WWWW_WWOBPWW
WWWW__W_WW_W
WWWW__WWWWWW
WW_WW_____WW
WWW_W_WW__WW
W__WW_WWWWWW
WWWWWWWWWWWW
            
WWWWWWWWWWWW
WWWWW____G_W
W_____W___WW
WW____W____W
W_WW_W____GW
WWWW_WWGP_WW
WWWW__W_WW_W
WWWW__WWWWWW
WW_WW_____WW
WWW_W_WW__WW
W__WW_WWWWWW
WWWWWWWWWWWW
            
WWWWWWWWWWWW
WWWWW____G_W
W_____W___WW
WW____W____W
W_WW_W____GW
WWWW_WWGP_WW
WWWW__W_WW_W
WWWW__WWWWWW
WW_WW_____WW
WWW_W_WW__WW
W__WW_WWWWWW
WWWWWWWWWWWW
            
WWWWWWWWWWWW
WWWWW____G_W
W_____W___WW
WW____W____W
W_WW_W__P_GW
WWWW_WWG__WW
WWWW__W_WW_W
WWWW__WWWWWW
WW_WW_____WW
WWW_W_WW__WW
W__WW_WWWWWW
WWWWWWWWWWWW
META {"type": "solver", "id": "pysat-gluecard41", "objective": 0}
