WWWWWWWWWWWW
W__W_____POW
W_WW_W_WB__W
WW_O_____BBW
WW_W_WW_WWOW
W__WW__W_W_W
WW_WWW_____W
WW____WW_WWW
WWW_______WW
WW_W______WW
WW_W__WW___W
WWWWWWWWWWWW
            
WWWWWWWWWWWW
W__W______OW
W_WW_W_WBP_W
WW_O_____BBW
WW_W_WW_WWOW
W__WW__W_W_W
WW_WWW_____W
WW____WW_WWW
WWW_______WW
WW_W______WW
WW_W__WW___W
WWWWWWWWWWWW
            
WWWWWWWWWWWW
W__W______OW
W_WW_W_WB_PW
WW_O_____BBW
WW_W_WW_WWOW
W__WW__W_W_W
WW_WWW_____W
WW____WW_WWW
WWW_______WW
WW_W______WW
WW_W__WW___W
WWWWWWWWWWWW
            
WWWWWWWWWWWW
W__W______OW
W_WW_W_WB__W
WW_O_____BPW
WW_W_WW_WWGW
W__WW__W_W_W
WW_WWW_____W
WW____WW_WWW
WWW_______WW
WW_W______WW
WW_W__WW___W
WWWWWWWWWWWW
            
WWWWWWWWWWWW
W__W______OW
W_WW_W_WB__W
WW_O____BP_W
WW_W_WW_WWGW
W__WW__W_W_W
WW_WWW_____W
WW____WW_WWW
WWW_______WW
WW_W______WW
WW_W__WW___W
WWWWWWWWWWWW
            
WWWWWWWWWWWW
W__W______OW
W_WW_W_WB__W
WW_O___BP__W
WW_W_WW_WWGW
W__WW__W_W_W
WW_WWW_____W
WW____WW_WWW
WWW_______WW
WW_W______WW
WW_W__WW___W
WWWWWWWWWWWW
            
WWWWWWWWWWWW
W__W____B_OW
W_WW_W_WP__W
WW_O___B___W
WW_W_WW_WWGW
W__WW__W_W_W
WW_WWW_____W
WW____WW_WWW
WWW_______WW
WW_W______WW
WW_W__WW___W
WWWWWWWWWWWW
            
WWWWWWWWWWWW
W__W____B_OW
W_WW_W_W___W
WW_O___BP__W
WW_W_WW_WWGW
W__WW__W_W_W
WW_WWW_____W
WW____WW_WWW
WWW_______WW
WW_W______WW
WW_W__WW___W
WWWWWWWWWWWW
            
WWWWWWWWWWWW
W__W____B_OW
W_WW_W_W___W
WW_O__BP___W
WW_W_WW_WWGW
W__WW__W_W_W
WW_WWW_____W
WW____WW_WWW
WWW_______WW
WW_W______WW
WW_W__WW___W
WWWWWWWWWWWW
            
WWWWWWWWWWWW
W__W____B_OW
W_WW_W_W___W
WW_O_BP____W
WW_W_WW_WWGW
W__WW__W_W_W
WW_WWW_____W
WW____WW_WWW
WWW_______WW
WW_W______WW
WW_W__WW___W
WWWWWWWWWWWW
            
WWWWWWWWWWWW
W__W____B_OW
W_WW_W_W___W
WW_O_BP____W
WW_W_WW_WWGW
W__WW__W_W_W
WW_WWW_____W
WW____WW_WWW
WWW_______WW
WW_W______WW
WW_W__WW___W
WWWWWWWWWWWW
            
WWWWWWWWWWWW
W__W____B_OW
W_WW_W_W___W
WW_OBP_____W
WW_W_WW_WWGW
W__WW__W_W_W
WW_WWW_____W
WW____WW_WWW
WWW_______WW
WW_W______WW
WW_W__WW___W
WWWWWWWWWWWW
            
WWWWWWWWWWWW
W__W____B_OW
W_WW_W_W___W
WW_GP______W
WW_W_WW_WWGW
W__WW__W_W_W
WW_WWW_____W
WW____WW_WWW
WWW_______WW
WW_W______WW
WW_W__WW___W
WWWWWWWWWWWW
            
WWWWWWWWWWWW
W__W____B_OW
W_WWPW_W___W
WW_G_______W
WW_W_WW_WWGW
W__WW__W_W_W
WW_WWW_____W
WW____WW_WWW
WWW_______WW
WW_W______WW
WW_W__WW___W
WWWWWWWWWWWW
            
WWWWWWWWWWWW
W__WP___B_OW
W_WW_W_W___W
WW_G_______W
WW_W_WW_WWGW
W__WW__W_W_W
WW_WWW_____W
WW____WW_WWW
WWW_______WW
WW_W______WW
WW_W__WW___W
WWWWWWWWWWWW
            
WWWWWWWWWWWW
W__W_P__B_OW
W_WW_W_W___W
WW_G_______W
WW_W_WW_WWGW
W__WW__W_W_W
WW_WWW_____W
WW____WW_WWW
WWW_______WW
WW_W______WW
WW_W__WW___W
WWWWWWWWWWWW
            
WWWWWWWWWWWW
W__W__P_B_OW
W_WW_W_W___W
WW_G_______W
WW_W_WW_WWGW
W__WW__W_W_W
WW_WWW_____W
WW____WW_WWW
WWW_______WW
WW_W______WW
WW_W__WW___W
WWWWWWWWWWWW
            
WWWWWWWWWWWW
W__W___PB_OW
W_WW_W_W___W
WW_G_______W
WW_W_WW_WWGW
W__WW__W_W_W
WW_WWW_____W
WW____WW_WWW
WWW_______WW
WW_W______WW
WW_W__WW___W
WWWWWWWWWWWW
            
WWWWWWWWWWWW
W__W____PBOW
W_WW_W_W___W
WW_G_______W
WW_W_WW_WWGW
W__WW__W_W_W
WW_WWW_____W
WW____WW_WWW
WWW_______WW
WW_W______WW
WW_W__WW___W
WWWWWWWWWWWW
            
WWWWWWWWWWWW
W__W_____PGW
W_WW_W_W___W
WW_G_______W
WW_W_WW_WWGW
W__WW__W_W_W
WW_WWW_____W
WW____WW_WWW
WWW_______WW
WW_W______WW
WW_W__WW___W
WWWWWWWWWWWW
META {"type": "solver", "id": "pysat-gluecard41", "objective": 0}
