__________
B_B__B____
P____PB___
B_P___W___
BBW_______
B_W_PWDW_B
WWWWWWWWWW
