___WW____W
__W______W
_W_______W
W________W
W_____P__W
W_W_WWWWWW
WWWWWWWWWW
