___WW____W
__W______W
_W_______W
W________W
W________W
W_W_WW...W
WWWWWWWWWW
