________
________
_____D__
__D__P__
__P_____
________
________
________