______B_W_
_____BB_W_
__WWWWWWW_
_W_______W
W________W
W____P__DW
WWWWWWWWWW
