_ _ _ _ _
_ _ _ _ _
_ O _ _ _
_ _ _ _ _
_ P _ B _
_ _ _ _ _