__W___WWBW
________WW
___B_B____
___P_P____
BB_B_B___P
BW_W_WBWBW
WWWWWWWWWW
