__WW__WW_W
B_______WW
__________
____B__B__
BB_BPB_P_P
BWPW_WBWBW
WWWWWWWWWW
