YYYYYYYY
Y---YYYY
YYY-YYYY
YYY-YYYY
YYY-YYYY
YYY-YYYY
YYY---FY
YYYYYYYY