____B_____
____P_____
____B___W_
____WW___W
W________W
W_B_DW__DW
WWWWWWWWWW
