_____P____
P______BPB
B_B_____W_
____WW___W
W________W
W___DW_PDW
WWWWWWWWWW
