___P__W___
__________
B_________
____B_____
__B_PB__BP
_PB_WBP__W
WWWWWWWWWW
