B_____W___
___P____B_
___B______
B__P_P_P_B
__B__B___P
P_B_WBBP_W
WWWWWWWWWW
