__________
_________P
__________
__________
___B______
_P_P__WBPB
WWWWWWWWWW
