_______P_P
_B__D_____
__B_W_B__P
__W______B
B___P___BB
B____W_BPB
WWWWWWWWWW
