[
    [
        ["_","_","_","_","_","_","_","_","_","_"],
        ["_","_","_","_","_","_","_","_","_","_"],
        ["_","_","_","_","_","_","_","_","_","_"],
        ["_","_","_","_","W","_","_","_","_","_"],
        ["_","_","_","_","W","_","_","_","_","_"],
        ["_","_","_","_","W","_","_","_","_","_"],
        ["H","_","_","_","W","_","_","_","_","O"],
        ["W","W","W","W","W","W","W","W","W","W"]
    ],
    [
        ["_","_","_","_","_","_","_","_","_","_"],
        ["_","_","_","_","_","_","_","_","_","_"],
        ["_","_","_","_","_","_","_","_","_","_"],
        ["_","_","_","_","W","_","_","_","_","_"],
        ["_","_","_","_","W","_","_","_","_","_"],
        ["_","_","_","_","W","_","_","_","_","_"],
        ["B","H","_","_","W","_","_","_","_","O"],
        ["W","W","W","W","W","W","W","W","W","W"]
    ],
    [
        ["_","_","_","_","_","_","_","_","_","_"],
        ["_","_","_","_","_","_","_","_","_","_"],
        ["_","_","_","_","_","_","_","_","_","_"],
        ["_","_","_","_","W","_","_","_","_","_"],
        ["_","_","_","_","W","_","_","_","_","_"],
        ["_","_","_","_","W","_","_","_","_","_"],
        ["B","B","H","_","W","_","_","_","_","O"],
        ["W","W","W","W","W","W","W","W","W","W"]
    ],
    [
        ["_","_","_","_","_","_","_","_","_","_"],
        ["_","_","_","_","_","_","_","_","_","_"],
        ["_","_","_","_","_","_","_","_","_","_"],
        ["_","_","_","_","W","_","_","_","_","_"],
        ["_","_","_","_","W","_","_","_","_","_"],
        ["_","_","_","_","W","_","_","_","_","_"],
        ["B","B","B","H","W","_","_","_","_","O"],
        ["W","W","W","W","W","W","W","W","W","W"]
    ],
    [
        ["_","_","_","_","_","_","_","_","_","_"],
        ["_","_","_","_","_","_","_","_","_","_"],
        ["_","_","_","_","_","_","_","_","_","_"],
        ["_","_","_","_","W","_","_","_","_","_"],
        ["_","_","_","_","W","_","_","_","_","_"],
        ["_","_","_","H","W","_","_","_","_","_"],
        ["B","B","B","V","W","_","_","_","_","O"],
        ["W","W","W","W","W","W","W","W","W","W"]
    ],
    [
        ["_","_","_","_","_","_","_","_","_","_"],
        ["_","_","_","_","_","_","_","_","_","_"],
        ["_","_","_","_","_","_","_","_","_","_"],
        ["_","_","_","_","W","_","_","_","_","_"],
        ["_","_","_","_","W","_","_","_","_","_"],
        ["_","_","H","B","W","_","_","_","_","_"],
        ["B","B","B","V","W","_","_","_","_","O"],
        ["W","W","W","W","W","W","W","W","W","W"]
    ],
    [
        ["_","_","_","_","_","_","_","_","_","_"],
        ["_","_","_","_","_","_","_","_","_","_"],
        ["_","_","_","_","_","_","_","_","_","_"],
        ["_","_","_","_","W","_","_","_","_","_"],
        ["_","_","_","_","W","_","_","_","_","_"],
        ["_","H","B","B","W","_","_","_","_","_"],
        ["B","B","B","V","W","_","_","_","_","O"],
        ["W","W","W","W","W","W","W","W","W","W"]
    ],
    [
        ["_","_","_","_","_","_","_","_","_","_"],
        ["_","_","_","_","_","_","_","_","_","_"],
        ["_","_","_","_","_","_","_","_","_","_"],
        ["_","_","_","_","W","_","_","_","_","_"],
        ["_","H","_","_","W","_","_","_","_","_"],
        ["_","V","B","B","W","_","_","_","_","_"],
        ["B","B","B","V","W","_","_","_","_","O"],
        ["W","W","W","W","W","W","W","W","W","W"]
    ],
    [
        ["_","_","_","_","_","_","_","_","_","_"],
        ["_","_","_","_","_","_","_","_","_","_"],
        ["_","_","_","_","_","_","_","_","_","_"],
        ["_","_","_","_","W","_","_","_","_","_"],
        ["_","B","H","_","W","_","_","_","_","_"],
        ["_","V","B","B","W","_","_","_","_","_"],
        ["B","B","B","V","W","_","_","_","_","O"],
        ["W","W","W","W","W","W","W","W","W","W"]
    ],
    [
        ["_","_","_","_","_","_","_","_","_","_"],
        ["_","_","_","_","_","_","_","_","_","_"],
        ["_","_","_","_","_","_","_","_","_","_"],
        ["_","_","_","_","W","_","_","_","_","_"],
        ["_","B","B","H","W","_","_","_","_","_"],
        ["_","V","B","B","W","_","_","_","_","_"],
        ["B","B","B","V","W","_","_","_","_","O"],
        ["W","W","W","W","W","W","W","W","W","W"]
    ],
    [
        ["_","_","_","_","_","_","_","_","_","_"],
        ["_","_","_","_","_","_","_","_","_","_"],
        ["_","_","_","_","_","_","_","_","_","_"],
        ["_","_","_","H","W","_","_","_","_","_"],
        ["_","B","B","V","W","_","_","_","_","_"],
        ["_","V","B","B","W","_","_","_","_","_"],
        ["B","B","B","V","W","_","_","_","_","O"],
        ["W","W","W","W","W","W","W","W","W","W"]
    ],
    [
        ["_","_","_","_","_","_","_","_","_","_"],
        ["_","_","_","_","_","_","_","_","_","_"],
        ["_","_","_","H","_","_","_","_","_","_"],
        ["_","_","_","V","W","_","_","_","_","_"],
        ["_","B","B","V","W","_","_","_","_","_"],
        ["_","V","B","B","W","_","_","_","_","_"],
        ["B","B","B","V","W","_","_","_","_","O"],
        ["W","W","W","W","W","W","W","W","W","W"]
    ],
    [
        ["_","_","_","_","_","_","_","_","_","_"],
        ["_","_","_","_","_","_","_","_","_","_"],
        ["_","_","_","B","H","_","_","_","_","_"],
        ["_","_","_","V","W","_","_","_","_","_"],
        ["_","B","B","V","W","_","_","_","_","_"],
        ["_","V","B","B","W","_","_","_","_","_"],
        ["B","B","B","V","W","_","_","_","_","O"],
        ["W","W","W","W","W","W","W","W","W","W"]
    ],
    [
        ["_","_","_","_","_","_","_","_","_","_"],
        ["_","_","_","_","_","_","_","_","_","_"],
        ["_","_","_","B","B","H","_","_","_","_"],
        ["_","_","_","V","W","_","_","_","_","_"],
        ["_","B","B","V","W","_","_","_","_","_"],
        ["_","V","B","B","W","_","_","_","_","_"],
        ["B","B","B","V","W","_","_","_","_","O"],
        ["W","W","W","W","W","W","W","W","W","W"]
    ],
    [
        ["_","_","_","_","_","_","_","_","_","_"],
        ["_","_","_","_","_","_","_","_","_","_"],
        ["_","_","_","B","B","B","_","_","_","_"],
        ["_","_","_","V","W","H","_","_","_","_"],
        ["_","B","B","V","W","_","_","_","_","_"],
        ["_","V","B","B","W","_","_","_","_","_"],
        ["B","B","B","V","W","_","_","_","_","O"],
        ["W","W","W","W","W","W","W","W","W","W"]
    ],
    [
        ["_","_","_","_","_","_","_","_","_","_"],
        ["_","_","_","_","_","_","_","_","_","_"],
        ["_","_","_","B","B","B","_","_","_","_"],
        ["_","_","_","V","W","B","_","_","_","_"],
        ["_","B","B","V","W","H","_","_","_","_"],
        ["_","V","B","B","W","_","_","_","_","_"],
        ["B","B","B","V","W","_","_","_","_","O"],
        ["W","W","W","W","W","W","W","W","W","W"]
    ],
    [
        ["_","_","_","_","_","_","_","_","_","_"],
        ["_","_","_","_","_","_","_","_","_","_"],
        ["_","_","_","B","B","B","_","_","_","_"],
        ["_","_","_","V","W","B","_","_","_","_"],
        ["_","B","B","V","W","B","_","_","_","_"],
        ["_","V","B","B","W","H","_","_","_","_"],
        ["B","B","B","V","W","_","_","_","_","O"],
        ["W","W","W","W","W","W","W","W","W","W"]
    ],
    [
        ["_","_","_","_","_","_","_","_","_","_"],
        ["_","_","_","_","_","_","_","_","_","_"],
        ["_","_","_","B","B","B","_","_","_","_"],
        ["_","_","_","V","W","B","_","_","_","_"],
        ["_","B","B","V","W","B","_","_","_","_"],
        ["_","V","B","B","W","B","_","_","_","_"],
        ["B","B","B","V","W","H","_","_","_","O"],
        ["W","W","W","W","W","W","W","W","W","W"]
    ],
    [
        ["_","_","_","_","_","_","_","_","_","_"],
        ["_","_","_","_","_","_","_","_","_","_"],
        ["_","_","_","B","B","B","_","_","_","_"],
        ["_","_","_","V","W","B","_","_","_","_"],
        ["_","B","B","V","W","B","_","_","_","_"],
        ["_","V","B","B","W","B","_","_","_","_"],
        ["B","B","B","V","W","B","H","_","_","O"],
        ["W","W","W","W","W","W","W","W","W","W"]
    ],
    [
        ["_","_","_","_","_","_","_","_","_","_"],
        ["_","_","_","_","_","_","_","_","_","_"],
        ["_","_","_","B","B","B","_","_","_","_"],
        ["_","_","_","V","W","B","_","_","_","_"],
        ["_","B","B","V","W","B","_","_","_","_"],
        ["_","V","B","B","W","B","_","_","_","_"],
        ["B","B","B","V","W","B","B","H","_","O"],
        ["W","W","W","W","W","W","W","W","W","W"]
    ],
    [
        ["_","_","_","_","_","_","_","_","_","_"],
        ["_","_","_","_","_","_","_","_","_","_"],
        ["_","_","_","B","B","B","_","_","_","_"],
        ["_","_","_","V","W","B","_","_","_","_"],
        ["_","B","B","V","W","B","_","_","_","_"],
        ["_","V","B","B","W","B","_","_","_","_"],
        ["B","B","B","V","W","B","B","B","H","O"],
        ["W","W","W","W","W","W","W","W","W","W"]
    ],
    [
        ["_","_","_","_","_","_","_","_","_","_"],
        ["_","_","_","_","_","_","_","_","_","_"],
        ["_","_","_","B","B","B","_","_","_","_"],
        ["_","_","_","V","W","B","_","_","_","_"],
        ["_","B","B","V","W","B","_","_","_","_"],
        ["_","V","B","B","W","B","_","_","_","_"],
        ["B","B","B","V","W","B","B","B","B","G"],
        ["W","W","W","W","W","W","W","W","W","W"]
    ],
    [
        ["_","_","_","_","_","_","_","_","_","_"],
        ["_","_","_","_","_","_","_","_","_","_"],
        ["_","_","_","B","B","B","_","_","_","_"],
        ["_","_","_","V","W","B","_","_","_","_"],
        ["_","B","B","V","W","B","_","_","_","_"],
        ["_","V","B","B","W","B","_","_","_","_"],
        ["B","B","B","V","W","B","B","B","B","G"],
        ["W","W","W","W","W","W","W","W","W","W"]
    ],
    [
        ["_","_","_","_","_","_","_","_","_","_"],
        ["_","_","_","_","_","_","_","_","_","_"],
        ["_","_","_","B","B","B","_","_","_","_"],
        ["_","_","_","V","W","B","_","_","_","_"],
        ["_","B","B","V","W","B","_","_","_","_"],
        ["_","V","B","B","W","B","_","_","_","_"],
        ["B","B","B","V","W","B","B","B","B","G"],
        ["W","W","W","W","W","W","W","W","W","W"]
    ]
]  