__________
__________
__PD___D__
__________
__________
__D_______
__P____P__
__________
__________
__________