__________
__________
__PD___D__
_______P__
__________
__D_______
__P_______
__________
__________
__________