W__WBWB__P
W__WBWWWWW
____W_____
__________
BPBP_BB__W
W_W_BPB_BW
WWWWWWWWWW
