W__W_W___B
W__W_WWWWW
____W_____
______B___
BBB___P_BW
WPW___B_BW
WWWWWWWWWW
