________
________
___D__P_
________
________
_D______
____P___
________