____W_W___
______W___
_________B
_____B___B
_BBB_W___B
PWPB_WBBBW
WWWWWWWWWW
