______________________
______________________
______________________
____BBB_______________
____VWB_______________
__BBVWB______BBBBB____
__VBBWB______VWBVBH___
_BBBVWBBBBBBBVWBVW__O_
_WWWWWWWWWWWWWWWWWWWW_
WWWWWWWWWWWWWWWWWWWWWW