__________
B__P______
___B___B__
___P___B__
W__B_B_P__
W__B_PB_B_
WWWWWWWWWW
