__________
__________
B__B______
P__P___B__
W__B_____B
W_PBBPBPBP
WWWWWWWWWW
