__________
_B____B___
__________
___PB_____
WB_B__B___
WP_BB_P_B_
WWWWWWWWWW
