____W_____
___W_W____
__W___W___
_W_____W__
W_______W_
W________W
W________W
W________W
W__P_B__DW
WWWWWWWWWW
