______P_B_
__________
__________
_B______B_
_P___B__P_
_BW_WP__BB
WWWWWWWWWW
