__________
____P_B___
____BBW___
BBB_WW____
_B____WBBB
_BPBB_WPWP
WWWWWWWWWW
