__________
______B___
______P___
__B____PBB
__B___BBW_
W_P_BBBBWP
WWWWWWWWWW
