___P______
_____B____
__P__P____
__B_____B_
__B___BBWB
W_P_B_BBWP
WWWWWWWWWW
