_B_P______
_P___B____
___P_P_B__
__B____PB_
__B__BB_W_
W_P__PB_WP
WWWWWWWWWW
