___P______
_P________
_____P__B_
_PBP___PB_
__B___B_WB
W_P_BPBPWP
WWWWWWWWWW
