_W_W______
_WW_______
W_________
___B_____W
___W_BPBPW
WBBWBBWBWW
WWWWWWWWWW
