_W_W______
_WW_______
W_________
______B_BW
P__W__P_PW
WB_WBBWBWW
WWWWWWWWWW
