______________________
______________________
______________________
______________________
______________________
________BBB__BBBBB____
________BWV__VWBVBB___
_O__HBBBBWVBBVWBVWBBG_
_WWWWWWWWWWWWWWWWWWWW_
WWWWWWWWWWWWWWWWWWWWWW