_ _ _ _ _ _
_ _ O _ _ _
_ _ _ _ _ _
_ _ _ B P _
_ _ _ _ _ _
_ _ _ _ _ _