_ _ _ _ _ _ _ _
_ _ _ _ _ _ _ _
_ _ _ _ _ _ P _
_ _ P G _ _ G _
_ _ _ _ _ _ _ _
_ _ _ _ _ _ _ _
_ _ _ _ P G _ _
_ _ _ _ _ _ _ _