_ _ _ _ _ _
_ _ G _ _ _
_ _ P _ _ _
_ _ _ _ _ _
_ _ _ _ _ _
_ _ _ _ _ _