. . . . . .
. . . . D .
. . . . . .
. . . . . .
. P . . . .
. . . . . .