. . . . D .
. . . . . .
. . . . . .
. . . . . .
. . . . . .
. . . . . P