_W__WW____
_________B
_________P
____W_____
____D__B__
_D__W__P_B
WWWWWWWWWW
