WWWWWW
W_DW_W
W_WW_W
W__P_W
WWWWWW
WWWWWW