P_W_B_B___
W_W_P_P___
D_____B__B
W__P__B__W
W_B___B___
D_B_BBB_PW
WWWWWWWWWW
