__WB____B_
W__W____W_
D_______W_
W_________
___B_B___B
DW_PWW_PBP
WWWWWWWWWW
