W W W W W W
W _ _ _ W W
W P W D W W
W _ W W W W
W _ _ _ W W
W W W W W W