W W W W W W
W _ _ P W W
W _ W D W W
W _ W W W W
W _ _ _ W W
W W W W W W