_______W__
W______W__
W_________
________P_
_B____BBB_
_W_D__PBPB
WWWWWWWWWW
