_W__...__W
_W_______W
W________.
W______P..
W______...
W__W__W__W
WWWWWWWWWW
