_WPBP__B__
_WWWWW_P__
_____WB___
_____WBP__
_W_W__W___
PW_D_PWBP_
WWWWWWWWWW
