. . . . . .
. . P . . .
. . . . . .
. . . . . D
. . . . . .
. . . . . .