WWWWWW
W_P_WW
WDW_WW
WWW_WW
W___WW
WWWWWW