W W W W W W
W W _ _ _ W
W W _ W D W
W W P W W W
W W _ _ _ W
W W W W W W