W W W W W W
W W P _ _ W
W W _ W D W
W W _ W W W
W W _ _ _ W
W W W W W W