WWWWWWWW
WWWWWWWW
WD__PDWW
W_____WW
WP____WW
W___PDWW
WWWWWWWW
WWWWWWWW