[
    [
        ["W","W","W","W","W","W","W"],
        ["W","_","_","_","_","_","W"],
        ["W","_","W","_","W","_","W"],
        ["W","W","W","_","W","D","W"],
        ["W","P","_","_","W","W","W"],
        ["W","_","W","W","W","_","W"],
        ["W","_","_","_","_","_","W"],
        ["W","W","W","W","W","W","W"]
    ],
    [
        ["W","W","W","W","W","W","W"],
        ["W","_","_","_","_","_","W"],
        ["W","_","W","_","W","_","W"],
        ["W","W","W","_","W","D","W"],
        ["W","_","P","_","W","W","W"],
        ["W","_","W","W","W","_","W"],
        ["W","_","_","_","_","_","W"],
        ["W","W","W","W","W","W","W"]
    ],
    [
        ["W","W","W","W","W","W","W"],
        ["W","_","_","_","_","_","W"],
        ["W","_","W","_","W","_","W"],
        ["W","W","W","_","W","D","W"],
        ["W","_","_","P","W","W","W"],
        ["W","_","W","W","W","_","W"],
        ["W","_","_","_","_","_","W"],
        ["W","W","W","W","W","W","W"]
    ],
    [
        ["W","W","W","W","W","W","W"],
        ["W","_","_","_","_","_","W"],
        ["W","_","W","_","W","_","W"],
        ["W","W","W","P","W","D","W"],
        ["W","_","_","_","W","W","W"],
        ["W","_","W","W","W","_","W"],
        ["W","_","_","_","_","_","W"],
        ["W","W","W","W","W","W","W"]
    ],
    [
        ["W","W","W","W","W","W","W"],
        ["W","_","_","_","_","_","W"],
        ["W","_","W","P","W","_","W"],
        ["W","W","W","_","W","D","W"],
        ["W","_","_","_","W","W","W"],
        ["W","_","W","W","W","_","W"],
        ["W","_","_","_","_","_","W"],
        ["W","W","W","W","W","W","W"]
    ],
    [
        ["W","W","W","W","W","W","W"],
        ["W","_","_","P","_","_","W"],
        ["W","_","W","_","W","_","W"],
        ["W","W","W","_","W","D","W"],
        ["W","_","_","_","W","W","W"],
        ["W","_","W","W","W","_","W"],
        ["W","_","_","_","_","_","W"],
        ["W","W","W","W","W","W","W"]
    ],
    [
        ["W","W","W","W","W","W","W"],
        ["W","_","_","_","P","_","W"],
        ["W","_","W","_","W","_","W"],
        ["W","W","W","_","W","D","W"],
        ["W","_","_","_","W","W","W"],
        ["W","_","W","W","W","_","W"],
        ["W","_","_","_","_","_","W"],
        ["W","W","W","W","W","W","W"]
    ],
    [
        ["W","W","W","W","W","W","W"],
        ["W","_","_","_","_","P","W"],
        ["W","_","W","_","W","_","W"],
        ["W","W","W","_","W","D","W"],
        ["W","_","_","_","W","W","W"],
        ["W","_","W","W","W","_","W"],
        ["W","_","_","_","_","_","W"],
        ["W","W","W","W","W","W","W"]
    ],
    [
        ["W","W","W","W","W","W","W"],
        ["W","_","_","_","_","_","W"],
        ["W","_","W","_","W","P","W"],
        ["W","W","W","_","W","D","W"],
        ["W","_","_","_","W","W","W"],
        ["W","_","W","W","W","_","W"],
        ["W","_","_","_","_","_","W"],
        ["W","W","W","W","W","W","W"]
    ],
    [
        ["W","W","W","W","W","W","W"],
        ["W","_","_","_","_","_","W"],
        ["W","_","W","_","W","P","W"],
        ["W","W","W","_","W","D","W"],
        ["W","_","_","_","W","W","W"],
        ["W","_","W","W","W","_","W"],
        ["W","_","_","_","_","_","W"],
        ["W","W","W","W","W","W","W"]
    ],
    [
        ["W","W","W","W","W","W","W"],
        ["W","_","_","_","_","_","W"],
        ["W","_","W","_","W","P","W"],
        ["W","W","W","_","W","D","W"],
        ["W","_","_","_","W","W","W"],
        ["W","_","W","W","W","_","W"],
        ["W","_","_","_","_","_","W"],
        ["W","W","W","W","W","W","W"]
    ]
]