________
_D__PD__
_P______
________
____D___
____P___
________
________