B_________
P____P____
B____BB___
P_B_BB____
__P__B____
B____B__PB
WWWWWWWWWW
