_____B____
_____B____
_____B___B
_B___P___P
__B__W__B_
BPWW_D_WP_
WWWWWWWWWW
