_____B___B
_____B____
_____B____
___B_P___P
_BBP_W__B_
_PWW_D_WP_
WWWWWWWWWW
