__________
_WWWWWWWW_
W________W
W________W
W________W
W___PB__DW
WWWWWW.WWW
