W________W
W________W
W________W
W________W
W________W
W___..W__W
WWWWWWWWWW
