_P_W_P_P_B
___D_____P
_P_W______
_____BPB__
B__D__B_BB
BPBWP_B_W_
WWWWWWWWWW
