___WW_____
__________
__________
_BPB___B__
_PW___BP_P
B_W_WPW_BB
WWWWWWWWWW
