B_________
P________P
B________W
P__B_WB___
_W_B_WW___
DWPBPWD__P
WWWWWWWWWW
