_____B____
_________P
B__P_____W
P__B_W____
_WBBBWW___
DWPBPWD__P
WWWWWWWWWW
