__________
__________
__________
___DP_____
__________
__________
__P__DP___
__D_______
__________
__________