___B_P____
_______B_B
B_W_WB____
_____W___P
_B_B______
WP_PW_D_P_
WWWWWWWWWW
