_W_________________
_W___WWWWWWWWWWWWW_
W_W_W_____________W
W__W______________W
W_________________W
W_________________W
W_WWW__B____BW__WW_
W_W_W__P_W_BWWWWW__
W_W_W___WWBBW______
WDW_WWWWWWBWW______
WWW_WW___WWW_______