_W_________________
_W___WWWWWWWWWWWWW_
W_W_W_____________W
W__W______________W
W_________________W
W_________________W
W_WWW________W__WW_
W_W_WB___W__WWWWW__
WPW_WBB_WWBBW______
WDW_WWWWWWBWW______
WWW_WW___WWW_______