_W_________________
_W___WWWWWWWWWWWWW_
W_W_W_____________W
W__W______________W
W____________B___BW
W____________P__BBW
W_WWW________W__WW_
W_W_W____W__WWWWW__
W_W_W___WW_BW______
WDW_WWWWWWBWW______
WWW_WW___WWW_______