_W_________________
_W___WWWWWWWWWWWWW_
W_W_W_____________W
W__W______________W
W_________________W
W______B__________W
W_WWW________W__WW_
W_W_W__PBW__WWWWW__
W_W_WB__WWBBW______
WDW_WWWWWWBWW______
WWW_WW___WWW_______