_W_________________
_W___WWWWWWWWWWWWW_
W_W_W_____________W
W__W______________W
W________________BW
W_______________BBW
W_WWW___B____WB_WW_
W_W_W___PW__WWWWW__
W_W_WB__WW__W______
WDW_WWWWWW_WW______
WWW_WW___WWW_______