WWWWWWWW
WWWWWWWW
WD_____W
WP_____W
W______W
W______W
WD__P__W
WWWWWWWW