WWWWWWWW
WWWWWWWW
WD_____W
WP_____W
W______W
W______W
WDP____W
WWWWWWWW