___B_W__P_
_W_W_WWWW_
_W_W____W_
_D________
_W_______B
WW_PB_W__B
WWWWWWWWWW
