_____W_BP_
_W_W_WWWW_
_W_W____W_
_D________
_W____P__P
WWB__BW__B
WWWWWWWWWW
