W_PBBW_WWW
_WWWWW____
__________
__________
_BP____B__
BPWBBB_WBW
WWWWWWWWWW
