___W_____W
_____W____
__________
__________
_____W_B_B
BP_B_D_P_P
WWWWWWWWWW
