___W_____W
_____W____
__________
__________
B_B__W_B_B
B_P__D_P_P
WWWWWWWWWW
