________
________
___PD___
________
________
____DP__
________
________