________
________
____DP__
________
________
___DP___
________
________