WWWWWWWW
WWWWWWWW
WW_PDW_W
WW_WWW_W
WW_____W
WW_WWW_W
WW_PDW_W
WWWWWWWW