________
________
___P_D__
________
________
___PD___
________
________