W__....__W
W________W
W________W
W________W
W____P___W
W___..._DW
WWWWWWWWWW
