

   ###................##   
 ##   ................  #  
####B ................BB## 
#  .....................# #
...........................
...........................
...........................
...........................
...........................
...........................
...........................
...........................
...........................
...........................
...........................
...........................
...........................
 ......................BB# 
 ......................### 


   #..................##   
 #..................... #  
#......................B## 
# ......................# #
...........................
...........................
...........................
...........................
...........................
...........................
...........................
...........................
...........................
...........................
...........................
...........................
...........................
 ......................BB# 
 ......................### 


   ##.................##   
 ##  .................  #  
####B................. B## 
#  ##.................### #
#   # .....................
...........................
...........................
...........................
...........................
...........................
...........................
...........................
...........................
...........................
...........................
...........................
...........................
 ......................BB# 
 ......................### 


   ###...............###   
 ##   ...............   #  
####B ...............  B## 
#  ## ................ .# #
...........................
...........................
...........................
...........................
...........................
...........................
...........................
...........................
...........................
...........................
...........................
...........................
...........................
 ......................BB# 
 ......................### 


   ###...............###   
 ##   ...............   #  
####B ...............  B## 
#  .....................# #
...........................
...........................
...........................
...........................
...........................
...........................
...........................
...........................
...........................
...........................
...........................
...........................
...........................
 ......................BB# 
 ......................### 


   ##.................##   
 ##  .................  #  
####B................. B## 
#  ##.................### #
# .........................
...........................
...........................
...........................
...........................
...........................
...........................
...........................
...........................
...........................
...........................
...........................
...........................
 ......................BB# 
 ......................### 


   #..................##   
 #..................... #  
#......................B## 
# ......................# #
...........................
...........................
...........................
...........................
...........................
...........................
...........................
...........................
...........................
...........................
...........................
...........................
...........................
 ......................BB# 
 ......................### 


   ##................###   
 ##  ................   #  
####B................  B## 
#  ##................  ## #
# .........................
...........................
...........................
...........................
...........................
...........................
...........................
...........................
...........................
...........................
...........................
...........................
...........................
 ......................BB# 
 ......................### 


   #..................##   
 #..................... #  
#......................B## 
# ......................# #
...........................
...........................
...........................
...........................
...........................
...........................
...........................
...........................
...........................
...........................
...........................
...........................
...........................
 ......................BB# 
 ......................### 


   #####..............##   
 ##     ..............  #  
####B B .............. B## 
#  ## ................### #
...........................
...........................
...........................
...........................
...........................
...........................
...........................
...........................
...........................
...........................
...........................
...........................
...........................
 ......................BB# 
 ......................### 
