_________W
B_B____P__
P_P_B____B
_BB_P_____
BWP___BP__
BW_B___BBB
WWWWWWWWWW
