____________
____________
____________
____________
____________
____________
____________
____________
____________
_BBBBBBBBHO_
_WWWWWWWWWW_
WWWWWWWWWWWW