WWWWWW
W____W
W____W
W____W
W_P_DW
WWWWWW