WWWWWW
W_DW_W
W_WW_W
W___PW
WWWWWW
WWWWWW