W___..___W
W________W
W________W
.________W
.P.__W___W
...__W__.W
WWWWWWWWWW
