W___..___W
W________W
W________W
.________W
._.__W___W
...__W___W
.WWWWWWWWW
