WWWWWW
WWWWWW
W_WD_W
W_WWPW
W____W
WWWWWW