___P___B__
_B___B___B
_____P____
_______P__
B__B_BWB__
WPW_WPWB__
WWWWWWWWWW
