....................
..____W_____..______
..____W_____________
..___PW_____________
.._.B_W_B_B___B___PB
...WWWW_PWBB__BB_WBB
WWWWWWWWWWWWWWWWWWWW
