_P________
_________P
________WW
__________
___BB___B_
___BP_WBP_
WWWWWWWWWW
