________B_
_P____B_P_
______P_WW
__________
_B_B______
_P_BP_WB__
WWWWWWWWWW
