______________________
______________________
______________________
______________________
______________________
__BBBB___BBB__________
__VBWB___VWB__________
_BBVWBBBBVWBBBBBBBH_O_
_WWWWWWWWWWWWWWWWWWWW_
WWWWWWWWWWWWWWWWWWWWWW