__B____B_B
PB_B_B_W_W
_BPBPB_WWW
WWWWWWWW__
_________B
__W_BWDP_B
WWWWWWWWWW
