W______W__
W_______W_
W________W
W________W
W________W
W___W____W
WWWWWWWWWW
