__________
____P___B_
P_B_B___P_
__P_WB___W
W____W___W
D_WP_D_D_D
WWWWWWWWWW
