_P_____P_B
___P____B_
P_B_B___P_
____W____W
W_P__W___W
DPW_PD_DPD
WWWWWWWWWW
