___W__W_PB
____WWWWWW
__________
B______B__
P_BW___P_B
W_BWB__B_B
WWWWWWWWWW
