W___W_____
_WWWW_____
_______P__
__________
_______B__
P_B_B_PW__
WWWWWWWWWW
