WWWWWW
WP__WW
W_WDWW
W_WWWW
W___WW
WWWWWW