______B__W
B__P__W_DW
P__W__WWWW
W__W______
W____B_B__
W_P_PBBPW_
WWWWWWWWWW
