______B__W
______W_DW
PB_W__WWWW
W__W______
W____B____
W____BBPW_
WWWWWWWWWW
