___B__B__W
___P__W_DW
P__W__WWWW
WB_W______
W______B__
W____BBPWP
WWWWWWWWWW
