.__.______
.__DP____W
._PWWWWWWW
._BW______
.BBW_____W
WWWW__W_WW
WWWWWWWWWW
