. . . . . .
. . . . . .
. . . . . P
. D . . . .
. . . . . .
. . . . . .