____________
____________
____________
____________
____________
____________
____________
____________
____________
_BBBBBBBH_O_
_WWWWWWWWWW_
WWWWWWWWWWWW