________
_D______
___P__P_
________
________
_D___D__
__P_____
________