________
_D______
_P______
________
____P___
_D___D__
_P______
________