WWWWWWWW
WWWWWWWW
WW___DWW
WW____WW
WW____WW
WW___PWW
WWWWWWWW
WWWWWWWW