W__B___W_B
W__P___W__
_____P___P
P__B______
B_PW_____B
WBWWB_BB_B
WWWWWWWWWW
