_ _ _ _ _ _
_ _ G P _ _
_ _ _ _ _ _
_ _ _ _ _ _
_ O B P _ _
_ _ _ _ _ _

***

_ _ _ _ _ _
_ _ G P _ _
_ _ _ _ _ _
_ _ _ _ _ _
_ G P _ _ _
_ _ _ _ _ _

***

_ _ _ _ _ _
_ _ G P _ _
_ _ _ _ _ _
_ _ _ _ _ _
_ G P _ _ _
_ _ _ _ _ _

***

_ _ _ _ _ _
_ _ G P _ _
_ _ _ _ _ _
_ _ _ _ _ _
_ G P _ _ _
_ _ _ _ _ _

***

_ _ _ _ _ _
_ _ G P _ _
_ _ _ _ _ _
_ _ _ _ _ _
_ G P _ _ _
_ _ _ _ _ _

***

_ _ _ _ _ _
_ _ G P _ _
_ _ _ _ _ _
_ _ _ _ _ _
_ G P _ _ _
_ _ _ _ _ _

***

T T T T T T
T T T T T T
T T T T T T
T T T T T T
T T T T T T
T T T T T T

***

