W__WWW___W
W_PW_____W
_WWW____W_
______PW__
B_B____W__
PWBBBWBWWB
WWWWWWWWWW
