__________
__________
__________
._________
._________
._W_______
....______
