________
______P_
___D____
________
________
_D______
____P___
________