__________
__________
__________
__________
__________
.._W.W_W_.
..........
