W_WWW_____
_______B__
__________
P___P_WP__
B____BWW__
BB_WBBWWW_
WWWWWWWWWW
