______________________
______________________
______________________
____BBB_______________
____VWB_______________
__BBVWB___BBB__BH_____
__VBBWB___BWV__VW_____
_BBBVWBBBBBWVBBVW___O_
_WWWWWWWWWWWWWWWWWWWW_
WWWWWWWWWWWWWWWWWWWWWW