______________________
______________________
______________________
____BBB_______________
____VWB_______________
__BBVWB___BBB__BBB____
__VBBWB___BWV__VWH____
_BBBVWBBBBBWVBBVW___O_
_WWWWWWWWWWWWWWWWWWWW_
WWWWWWWWWWWWWWWWWWWWWW