______________________
______________________
______________________
____BBB_______________
____VWB_______________
__BBVWB___BBB__BBB____
__VBBWB___BWV__VWB____
_BBBVWBBBBBWVBBVWBBHO_
_WWWWWWWWWWWWWWWWWWWW_
WWWWWWWWWWWWWWWWWWWWWW