__________
__________
_______P__
_______D__
____D_____
____P_____
_______D__
_______P__
__________
__________