W________W
W________W
W________W
W___.____W
W___W____W
W___WB___W
WWWWWWWWWW
