___B_____P
B_________
B__B_B____
B__B_BB__W
B__B_WP___
BP_BBWBBBW
WWWWWWWWWW
