___P______
___B______
B__B______
B__B_B_B_W
BB_B_W_P__
BP_BBWBBBW
WWWWWWWWWW
