__________
_P________
_______PBP
_______BB_
WB_B___BWB
WP_P_B_WWW
WWWWWWWWWW
