_B_WWWW__W
______W__W
_P________
________B_
__B__BBBP_
P_PW_WPW_B
WWWWWWWWWW
