______________________
______________________
______________________
____BBB_______________
____VWB_______________
__BBVWB__BBB__________
__VBBWB__VWB__HW______
_BBBVWBBBVWBBBVW____O_
_WWWWWWWWWWWWWWWWWWWW_
WWWWWWWWWWWWWWWWWWWWWW