______________________
______________________
______________________
____BBB_______________
____VWB_______________
__BBVWB__BBB__H_______
__VBBWB__VWB__VW______
_BBBVWBBBVWBBBVW____O_
_WWWWWWWWWWWWWWWWWWWW_
WWWWWWWWWWWWWWWWWWWWWW