______________________
______________________
______________________
____BBB_______________
____VWB_______________
__BBVWB__BBB__BBB_____
__VBBWB__VWB__VWH_____
_BBBVWBBBVWBBBVW____O_
_WWWWWWWWWWWWWWWWWWWW_
WWWWWWWWWWWWWWWWWWWWWW