______________________
______________________
______________________
____BBB_______________
____VWB_______________
__BBVWB__BBB__BBB_____
__VBBWB__VWB__VWB_____
_BBBVWBBBVWBBBVWBBBHO_
_WWWWWWWWWWWWWWWWWWWW_
WWWWWWWWWWWWWWWWWWWWWW