W___B__WBW
W_____W_W_
W___P_W___
W_________
W_B_B__P_P
D_W_W_WBB_
WWWWWWWWWW
