_____WBW_B
_____WBWWW
_____WW___
__________
_B_P___B_W
BW_B_B_BBW
WWWWWWWWWW
