_____WBW_B
_____WBWWW
_____WW___
________B_
_B__P__BPW
BW_B_B_BBW
WWWWWWWWWW
