W_________
_______W_P
__________
_____B____
__________
BP_PBP_BBB
WWWWWWWWWW
