________
_P______
________
____P___
____D___
________
_D______
________