________
________
________
____P___
_P__D___
________
_D______
________