_____P__P_
_______WWW
B____WW___
_W__W___B_
_WB_W__BBB
_WP_D_B_B_
WWWWWWWWWW
