W___WW___W
W________W
W________W
.________W
.._______W
....W____W
.WWWWWWWWW
