____...._W
____...._W
____...._W
____...._W
.___...._W
_WWWWWWWW_
W________W
W________W
W__W_____W
WWWWWWWWWW
