.________.
__WWW_____
_W___W____
W_____W___
W______W__
W_______W_
.________W
.P_______W
...__W___W
WWWWWWWWWW
