._________
__WWW_____
_W___W____
W_____W___
W______W__
W_______W_
W________W
W________W
W____W___W
WWWWWWWWWW
