____________
____________
____________
____________
____________
____________
____________
____________
____________
_BBBBBBBBBG_
_WWWWWWWWWW_
WWWWWWWWWWWW