_____WWWWW
__W_______
_PW______B
__W______P
P_W_WP____
_BW_WB_B__
WWWWWWWWWW
