_____WWWWW
__W_______
__W______B
__W_P_____
__W_W____P
PBW_WB_B__
WWWWWWWWWW
