_____WWWWW
__W_______
__W_______
__WP_____B
B_W_W____P
PBW_WB_B__
WWWWWWWWWW
