

     ###            
  #  #     # #     #
#   U         ....  
#...B        .....  
##...    BB  .....  
  ...    ####.....  
 #...    # # #####  
  #..               
  #..               
   ..               
  #.. # # ####      
  ##.   # ##        
    #  ###          
    #       #       
    #               
                    


        ####        
   #..    #       . 
  ###. #..  #  ###. 
 ##  . ##...  #   # 
 #   .   ...  ##    
     .   ...  #     
   ##.   ...  #     
  ## .   ... B#     
  ## .   ... .     #
     .   ... ..  ###
     .   ... ..   ##
   ##.   ... .. #  #
  .# #   ..# ...    
  .#     ..  .##    
  ##     ..  #      
         ##         


       # ###     #  
 B ...   # #..... . 
 #....  # ##....... 
  .... B  ##.B#.... 
  .... #..  .. .... 
  .... #..  .. #...#
  ..... ..  ... ...#
  ..... ..  ... ... 
  ..... ..  ... ... 
  ..... ..  ..# ... 
  ..... #.  ..  ... 
  .....  .  .#  ... 
  .....  .  .   #.. 
  #..##  #  #    .. 
   ##            .. 
                 ## 


      ##            
 ###             ## 
  ##             ## 
     #          ####
   # #  ##B   # #  #
  B###    .   #### #
  B#    B#.    ##  #
 ###   ###.    #  ##
         #.   . ####
#. .     #.   ..   #
## . U    .  #..  ##
#  . B    .  #.. ###
# #. #    .  ####  #
## ##    #.       ##
        # #         
                    


    ###     #       
  #  # .... #.. ####
    . ...... ..   ##
 #  ........... ####
 #  ........... ##  
    ......B#######. 
    ....... #  #  . 
    ........ .. . . 
    ............. . 
    ............. . 
    ............. .#
    .#..#....#... .#
    . .. .... ### ##
    . ## ....       
    .    ...#       
    #    ###        


            ###     
 ....... # ####     
 ....... ######   ##
 ....... # #   B    
 ........  #.  #. B#
 .......... .   . B#
 ..B#........   ..##
 ... ........   .. #
#... ........   ...#
 ... ##......   ...#
 ...   ......   ...#
 ...   ......   ...#
 ###   ......   ...#
       ###..#   ####
          ##       #
                    


     #### #### #### 
  ...    ### ####   
# ... #. #####   .. 
# .... #   # ##.... 
  ....         .... 
  ....         .B#. 
  ....         .. . 
 #....         .. . 
 ##...       B#.. . 
   ##.      ## .. ##
  .  #        ....##
  .           ##..##
  .             ..##
  #             ## #
                    
                    


  ##########    ### 
 ##  ### # #.. ##   
 #   # #. ##...  #. 
  . #  #..  ....  . 
 .. ######...... #. 
 ..       ....... ##
#..   #. #.......B##
#..    .  ........ #
#..    .  .#...... #
#..    .  . ...... #
#..    .  # ......  
 .#    #    ......  
#.          ######  
##                  
                    
                    


    ##              
        ### ##      
             #D   # 
          B   #     
########  B   #    #
          #   #    #
    ##              
      ##       #   #
      #  #        ##
#  #       #     ###
   ##            ###
   ##              #
 ## ## #     ##    #
 ##    #            
     # #            
   ####             


       #    #       
 .  B   .. ##.      
 .  BB#... ##.  B   
 .  ####...  . ###  
 .   #  ...  .      
#.      ...  .      
#. #  ##... #.    ##
#..     ... #. #   #
#..     B#. ##  B ##
#..     . ..  B#####
##.   ##. #.. ######
# #     #. ..    # #
         . .. .. ###
         . .. .. # #
        #. ## .#####
    #######   #     
