BBP______B
WW__B__B__
____P_PB__
__B___WW_B
__________
_______W__
WWWWWWWWWW
