BBP_______
WW____B__B
____P_PB__
B_____WW__
__B______B
P______W_P
WWWWWWWWWW
