_W____WW________WW____
_W________________W___
WW_________________W__
WD__________B_______W_
WW__________P________W
_W__________BW_______W
_W__________BWB______W
_WWWWW___WWWWWWWWWWWWW
_____W__BW____________
_____WWWWW____________