_W____WW________WW____
_W________________W___
WW_________________W__
WD__________________W_
WW__________BP_______W
_W___________W_______W
_W__________BWB__B___W
_WWWWW___WWWWWWWWWWWWW
_____W__BW____________
_____WWWWW____________