_W____WW________WW____
_W________________W___
WW_________________W__
WD__________________W_
WW___________________W
_W___________W_______W
_W__B________WB______W
_WWWWW_PBWWWWWWWWWWWWW
_____WB_BW____________
_____WWWWW____________