_W____WW________WW____
_W________________W___
WW_________________W__
WD__________________W_
WW___________________W
_W_________B_W_______W
_W________BPBWB______W
_WWWWW___WWWWWWWWWWWWW
_____W__BW____________
_____WWWWW____________