_W____WW________WW____
_W________________W___
WW_________________W__
WD__________________W_
WW____________B______W
_W___________WP______W
_W__________BWB__B___W
_WWWWW___WWWWWWWWWWWWW
_____W__BW____________
_____WWWWW____________