_W____WW________WW____
_W________________W___
WW_________________W__
WD__________________W_
WW___________________W
_W___________W_B_____W
_W__________BWBP_B___W
_WWWWW___WWWWWWWWWWWWW
_____W__BW____________
_____WWWWW____________