_W____WW________WW____
_W________________W___
WW_________________W__
WD__________________W_
WW___________________W
_W___________W_______W
_W______B_B_BWB______W
_WWWWW__PWWWWWWWWWWWWW
_____W__BW____________
_____WWWWW____________