_W____WW________WW____
_W________________W___
WW_________________W__
WD__________________W_
WW_________B_________W
_W__________BW_______W
_W_________PBWB______W
_WWWWW___WWWWWWWWWWWWW
_____W__BW____________
_____WWWWW____________