_W____WW________WW____
_W________________W___
WW_________________W__
WD__________________W_
WW______________P____W
_W___________W__B____W
_W___________WB_BB___W
_WWWWW___WWWWWWWWWWWWW
_____W__BW____________
_____WWWWW____________