_W____WW________WW____
_W________________W___
WW_________________W__
WD__________________W_
WW___________________W
_W___B_______W_______W
_W___P_______WB______W
_WWWWW__BWWWWWWWWWWWWW
_____WB_BW____________
_____WWWWW____________