_W____WW________WW____
_W________________W___
WW_________________W__
WD__________________W_
WW___________________W
_W___________W_______W
_W________B_BWB______W
_WWWWW_B_WWWWWWWWWWWWW
_____W_PBW____________
_____WWWWW____________