_W____WW________WW____
_W________________W___
WW_________________W__
WD__________________W_
WW___________________W
_W___________W_______W
_W_____B__B_BWB______W
_WWWWW___WWWWWWWWWWWWW
_____W_PBW____________
_____WWWWW____________