_W____WW________WW____
_W________________W___
WW_________________W__
WD__________________W_
WW___________________W
_W_______B___W_______W
_W_______P__BWB______W
_WWWWW___WWWWWWWWWWWWW
_____WB_BW____________
_____WWWWW____________