_W____WW________WW____
_W________________W___
WW_________________W__
WD__________________W_
WW___________________W
_WBP_________W_______W
_WBB_________WB______W
_WWWWW___WWWWWWWWWWWWW
_____WB__W____________
_____WWWWW____________