WWWWWW
WWWWWW
WPWD_W
W_WW_W
W____W
WWWWWW