..W______W
..W______W
...WW____W
_________W
W________W
W____W___W
WWWWWWWWWW
