W________W
W________W
W________W
W________W
.________W
.___W____W
.WWWWWWWWW
