WWWWWW
WWWWWW
W_WDPW
W_WW_W
W____W
WWWWWW
      
      
WWWWWW
WWWWWW
W_WDPW
W_WW_W
W____W
WWWWWW
      
      
WWWWWW
WWWWWW
W_WDPW
W_WW_W
W____W
WWWWWW
      
      
WWWWWW
WWWWWW
W_WDPW
W_WW_W
W____W
WWWWWW
      
      
WWWWWW
WWWWWW
W_WDPW
W_WW_W
W____W
WWWWWW
      
      
WWWWWW
WWWWWW
W_WDPW
W_WW_W
W____W
WWWWWW
META {"type": "solver", "id": "pysat-gluecard41", "objective": 0}
