__________
__________
__PW______
___WP_____
WW_WBB____
_WBWBBB___
WWWWWWWWWW
