[
  [
    "__________",
    "__________",
    "__P_______",
    "__________",
    "__________",
    "__________",
    "__________",
    "__________"
  ],
  [
    "__________",
    "__________",
    "___P______",
    "__________",
    "__________",
    "__________",
    "__________",
    "__________"
  ],
  [
    "__________",
    "__________",
    "____P_____",
    "__________",
    "__________",
    "__________",
    "__________",
    "__________"
  ],
  [
    "__________",
    "__________",
    "_____P____",
    "__________",
    "__________",
    "__________",
    "__________",
    "__________"
  ],
  [
    "__________",
    "__________",
    "______P___",
    "__________",
    "__________",
    "__________",
    "__________",
    "__________"
  ],
  [
    "__________",
    "__________",
    "_______P__",
    "__________",
    "__________",
    "__________",
    "__________",
    "__________"
  ],
  [
    "__________",
    "__________",
    "________P_",
    "__________",
    "__________",
    "__________",
    "__________",
    "__________"
  ],
  [
    "__________",
    "__________",
    "_______P__",
    "__________",
    "__________",
    "__________",
    "__________",
    "__________"
  ],
  [
    "__________",
    "__________",
    "______P___",
    "__________",
    "__________",
    "__________",
    "__________",
    "__________"
  ],
  [
    "__________",
    "__________",
    "_____P____",
    "__________",
    "__________",
    "__________",
    "__________",
    "__________"
  ],
  [
    "__________",
    "__________",
    "__________",
    "_____P____",
    "__________",
    "__________",
    "__________",
    "__________"
  ],
  [
    "__________",
    "__________",
    "__________",
    "__________",
    "_____P____",
    "__________",
    "__________",
    "__________"
  ],
  [
    "__________",
    "__________",
    "__________",
    "__________",
    "__________",
    "_____P____",
    "__________",
    "__________"
  ],
  [
    "__________",
    "__________",
    "__________",
    "__________",
    "__________",
    "____P_____",
    "__________",
    "__________"
  ],
  [
    "__________",
    "__________",
    "__________",
    "__________",
    "__________",
    "___P______",
    "__________",
    "__________"
  ],
  [
    "__________",
    "__________",
    "__________",
    "__________",
    "__________",
    "__P_______",
    "__________",
    "__________"
  ],
  [
    "__________",
    "__________",
    "__________",
    "__________",
    "__________",
    "___P______",
    "__________",
    "__________"
  ],
  [
    "__________",
    "__________",
    "__________",
    "__________",
    "__________",
    "____P_____",
    "__________",
    "__________"
  ],
  [
    "__________",
    "__________",
    "__________",
    "__________",
    "__________",
    "_____P____",
    "__________",
    "__________"
  ],
  [
    "__________",
    "__________",
    "__________",
    "__________",
    "__________",
    "__________",
    "_____P____",
    "__________"
  ]
]