[
  [
    "________",
    "________",
    "_P______",
    "________",
    "________",
    "________",
    "________",
    "________"
  ],
  [
    "________",
    "________",
    "__P_____",
    "________",
    "________",
    "________",
    "________",
    "________"
  ],
  [
    "________",
    "________",
    "________",
    "__P_____",
    "________",
    "________",
    "________",
    "________"
  ],
  [
    "________",
    "________",
    "________",
    "___P____",
    "________",
    "________",
    "________",
    "________"
  ],
  [
    "________",
    "________",
    "________",
    "________",
    "___P____",
    "________",
    "________",
    "________"
  ],
  [
    "________",
    "________",
    "________",
    "________",
    "____P___",
    "________",
    "________",
    "________"
  ],
  [
    "________",
    "________",
    "________",
    "________",
    "_____P__",
    "________",
    "________",
    "________"
  ],
  [
    "________",
    "________",
    "________",
    "_____P__",
    "________",
    "________",
    "________",
    "________"
  ],
  [
    "________",
    "________",
    "_____P__",
    "________",
    "________",
    "________",
    "________",
    "________"
  ],
  [
    "________",
    "________",
    "______P_",
    "________",
    "________",
    "________",
    "________",
    "________"
  ],
  [
    "________",
    "________",
    "_____P__",
    "________",
    "________",
    "________",
    "________",
    "________"
  ],
  [
    "________",
    "________",
    "________",
    "_____P__",
    "________",
    "________",
    "________",
    "________"
  ],
  [
    "________",
    "________",
    "________",
    "________",
    "_____P__",
    "________",
    "________",
    "________"
  ],
  [
    "________",
    "________",
    "________",
    "________",
    "________",
    "_____P__",
    "________",
    "________"
  ],
  [
    "________",
    "________",
    "________",
    "________",
    "________",
    "________",
    "_____P__",
    "________"
  ],
  [
    "________",
    "________",
    "________",
    "________",
    "________",
    "________",
    "______P_",
    "________"
  ],
  [
    "________",
    "________",
    "________",
    "________",
    "________",
    "________",
    "_____P__",
    "________"
  ],
  [
    "________",
    "________",
    "________",
    "________",
    "________",
    "________",
    "____P___",
    "________"
  ],
  [
    "________",
    "________",
    "________",
    "________",
    "________",
    "________",
    "___P____",
    "________"
  ],
  [
    "________",
    "________",
    "________",
    "________",
    "________",
    "________",
    "__P_____",
    "________"
  ]
]