________
_DP__D__
_____P__
________
__D_____
_P____P_
______D_
________