__W______W
_W_______W
W________W
W________W
W___W____W
W__BW____W
WWWWWWWWWW
