WWWWWWWW
W____PWW
W_W_W_WW
WWW_WDWW
W___WWWW
W_WWW_WW
W_____WW
WWWWWWWW