____WW____
______W___
_______W__
___.____W_
__W______W
_W_______W
W________W
W______...
W___W.....
WWWWWWW...
