_ _ _ _ _ _ _ _ _ _
_ _ _ _ _ _ _ _ _ _
_ _ _ _ _ _ _ P _ _
_ _ P _ D _ _ D _ _
_ _ _ _ _ _ _ _ _ _
_ _ _ _ _ _ _ _ _ _
_ _ P D _ _ _ _ _ _
_ _ _ _ _ _ P D _ _
_ _ _ _ _ _ _ _ _ _
_ _ _ _ _ _ _ _ _ _

***

_ _ _ _ _ _ _ _ _ _
_ _ _ _ _ _ _ _ _ _
_ _ _ _ _ _ _ P _ _
_ _ _ P D _ _ D _ _
_ _ _ _ _ _ _ _ _ _
_ _ _ _ _ _ _ _ _ _
_ _ P D _ _ _ _ _ _
_ _ _ _ _ _ P D _ _
_ _ _ _ _ _ _ _ _ _
_ _ _ _ _ _ _ _ _ _

***

_ _ _ _ _ _ _ _ _ _
_ _ _ _ _ _ _ _ _ _
_ _ _ _ _ _ _ P _ _
_ _ _ P D _ _ D _ _
_ _ _ _ _ _ _ _ _ _
_ _ _ _ _ _ _ _ _ _
_ _ P D _ _ _ _ _ _
_ _ _ _ _ _ P D _ _
_ _ _ _ _ _ _ _ _ _
_ _ _ _ _ _ _ _ _ _

***

_ _ _ _ _ _ _ _ _ _
_ _ _ _ _ _ _ _ _ _
_ _ _ _ _ _ _ P _ _
_ _ _ P D _ _ D _ _
_ _ _ _ _ _ _ _ _ _
_ _ _ _ _ _ _ _ _ _
_ _ P D _ _ _ _ _ _
_ _ _ _ _ _ P D _ _
_ _ _ _ _ _ _ _ _ _
_ _ _ _ _ _ _ _ _ _

***

_ _ _ _ _ _ _ _ _ _
_ _ _ _ _ _ _ _ _ _
_ _ _ _ _ _ _ P _ _
_ _ _ P D _ _ D _ _
_ _ _ _ _ _ _ _ _ _
_ _ _ _ _ _ _ _ _ _
_ _ P D _ _ _ _ _ _
_ _ _ _ _ _ P D _ _
_ _ _ _ _ _ _ _ _ _
_ _ _ _ _ _ _ _ _ _

***

_ _ _ _ _ _ _ _ _ _
_ _ _ _ _ _ _ _ _ _
_ _ _ _ _ _ _ P _ _
_ _ _ P D _ _ D _ _
_ _ _ _ _ _ _ _ _ _
_ _ _ _ _ _ _ _ _ _
_ _ P D _ _ _ _ _ _
_ _ _ _ _ _ P D _ _
_ _ _ _ _ _ _ _ _ _
_ _ _ _ _ _ _ _ _ _

***

_ _ _ _ _ _ _ _ _ _
_ _ _ _ _ _ _ _ _ _
_ _ _ _ _ _ _ P _ _
_ _ _ P D _ _ D _ _
_ _ _ _ _ _ _ _ _ _
_ _ _ _ _ _ _ _ _ _
_ _ P D _ _ _ _ _ _
_ _ _ _ _ _ P D _ _
_ _ _ _ _ _ _ _ _ _
_ _ _ _ _ _ _ _ _ _

***

_ _ _ _ _ _ _ _ _ _
_ _ _ _ _ _ _ _ _ _
_ _ _ _ _ _ _ P _ _
_ _ _ P D _ _ D _ _
_ _ _ _ _ _ _ _ _ _
_ _ _ _ _ _ _ _ _ _
_ _ P D _ _ _ _ _ _
_ _ _ _ _ _ P D _ _
_ _ _ _ _ _ _ _ _ _
_ _ _ _ _ _ _ _ _ _

***

_ _ _ _ _ _ _ _ _ _
_ _ _ _ _ _ _ _ _ _
_ _ _ _ _ _ _ P _ _
_ _ _ P D _ _ D _ _
_ _ _ _ _ _ _ _ _ _
_ _ _ _ _ _ _ _ _ _
_ _ P D _ _ _ _ _ _
_ _ _ _ _ _ P D _ _
_ _ _ _ _ _ _ _ _ _
_ _ _ _ _ _ _ _ _ _

***

_ _ _ _ _ _ _ _ _ _
_ _ _ _ _ _ _ _ _ _
_ _ _ _ _ _ _ P _ _
_ _ _ P D _ _ D _ _
_ _ _ _ _ _ _ _ _ _
_ _ _ _ _ _ _ _ _ _
_ _ P D _ _ _ _ _ _
_ _ _ _ _ _ P D _ _
_ _ _ _ _ _ _ _ _ _
_ _ _ _ _ _ _ _ _ _

***

T T T T T T T T T T
T T T T T T T T T T
T T T T T T T T T T
T T T T T T T T T T
T T T T T T T T T T
T T T T T T T T T T
T T T T T T T T T T
T T T T T T T T T T
T T T T T T T T T T
T T T T T T T T T T

***

