______....
_______P..
__WWWW....
_W_______.
W________.
W__W_____W
WWWWWWWWWW
