_________W
_________W
__WWWWWWW_
_W________
W________.
W__W_____W
WWWWWWWWWW
