_ _ _ _ _ _
_ P _ _ O _
_ B _ _ _ _
_ O _ _ B _
_ _ _ _ P _
_ _ _ _ _ _

***

_ _ _ _ _ _
_ _ _ _ O _
_ P _ _ B _
_ G _ _ P _
_ _ _ _ _ _
_ _ _ _ _ _

***

_ _ _ _ _ _
_ _ _ _ G _
_ P _ _ P _
_ G _ _ _ _
_ _ _ _ _ _
_ _ _ _ _ _

***

_ _ _ _ _ _
_ _ _ _ G _
_ P _ _ P _
_ G _ _ _ _
_ _ _ _ _ _
_ _ _ _ _ _

***

_ _ _ _ _ _
_ _ _ _ G _
_ P _ _ P _
_ G _ _ _ _
_ _ _ _ _ _
_ _ _ _ _ _

***

_ _ _ _ _ _
_ _ _ _ G _
_ P _ _ P _
_ G _ _ _ _
_ _ _ _ _ _
_ _ _ _ _ _

***

_ _ _ _ _ _
_ _ _ _ G _
_ P _ _ P _
_ G _ _ _ _
_ _ _ _ _ _
_ _ _ _ _ _

***

T T T T T T
T T T T T T
T T T T T T
T T T T T T
T T T T T T
T T T T T T

***

