__WWW__WDW
_______WWW
____B_____
B___P_B___
_B__W_B_B_
_BP_D_W_PW
WWWWWWWWWW
