B_WWW__WDW
P______WWW
__B_B_____
__P_P_____
BB__W_B___
_BP_D_W_PW
WWWWWWWWWW
