B_WWW_PWDW
P______WWW
____B_____
__P_P___B_
_B__W_____
BBP_D_W__W
WWWWWWWWWW
