__WWW_PWDW
P______WWW
__B_______
B_P_P_P___
_B__W___B_
BB_PDPW_PW
WWWWWWWWWW
