W W W W W W
W _ D W _ W
W _ W W _ W
W _ _ _ P W
W W W W W W
W W W W W W