W W W W W W
W _ D W _ W
W _ W W _ W
W P _ _ _ W
W W W W W W
W W W W W W