W________W
W________W
W________W
W________W
.....____W
...._____W
...._____W
...._WP__W
W.._BW__DW
WWWWWWWWWW
