W________W
W________W
W________W
W________W
W________W
W________W
W________W
W____W___W
W___BWP_DW
WWWWWWWWWW
