. . . . . .
. . . . . .
. . . . . .
. . P . . .
. . . . . .
. . D . . .