W____WW__W
W________W
W________W
W________W
W________W
W__W_____W
WWWWWWWWWW
