______WW__
__________
_________W
_B__W___PW
____D_P_WW
_PB_WP__DW
WWWWWWWWWW
