____B_WW__
____P_____
________BW
____W___PW
_B__D___WW
_P__WWP_DW
WWWWWWWWWW
