_____W....
_____W__..
.____WWW..
_WWWWW___W
W________W
W________W
W________W
W____W___W
W____WB__W
WWWWWWWWWW
