. B . . . .
. . . . . .
O . . . . .
. . . . . .
. . . . . .
. . . . . .