_WBPWBW___
_WWWWBW_W_
_____W_W_W
__________
__BB______
_WPW_WPWBW
WWWWWWWWWW
