_WBPW_W___
_WWWWBW_W_
_____W_W_W
__________
___B_P____
PWPW_W_W_W
WWWWWWWWWW
