XXXXXX.XXX
XXXXXXPXXX
XXXXXXXXXX
XXXXXXXXXX
XXXXXXXXXX
XXXXXXXXXX
WWWWWWWWWW
