P_________
W_________
W_________
_____W____
_____W___B
D_D__D__BB
WWWWWWWWWW
