W_____B__B
W____WP_WP
___WWWWWWW
___W______
___W__B___
__BW__PW__
WWWWWWWWWW
