B________W
B_____B___
W___B_P__P
__B_______
____P__B_P
BW_____WW_
WWWWWWWWWW
