W_W_B_W__W
WWWWWWW__W
__________
__________
WBB____W__
WBBB_BWWW_
WWWWWWWWWW
