W_WBBBW__W
WWWWWWW__W
__________
__________
W_B_B_PWP_
WBBBPBWWW_
WWWWWWWWWW
