WBW_B_W__W
WWWWWWW__W
__________
_______P__
W_BB___W_P
W_BBPBWWW_
WWWWWWWWWW
