__________________W_____
_________________W_W____
_______W________W___W___
______W_W______W_____W__
___WWW___W____W_______W_
__W_______W__W_________W
_W_________WW__________W
_W_____________________W
_W_____________________W
_W____P______________WWW
WW____W__________W___W__
WD____WB_________WWWWW__
WWWWWBWBB______WWW______
____W_WBBBW_W__W________
____WBWWWWWWWWWW________
____WWW_________________