__________________W_____
_________________W_W____
_______W________W___W___
______W_W______W_____W__
___WWW___W____W_______W_
__W_______W__W_________W
_W_________WW__________W
_W_____________________W
_W_____________________W
_W__________________BWWW
WW____W__________W_BBW__
WD____W______B__BWWWWW__
WWWWW_WB_______WWW______
____W_WB__W_WPBW________
____W_WWWWWWWWWW________
____WWW_________________