__________________W_____
_________________W_W____
_______W________W___W___
______W_W______W_____W__
___WWW___W____W_______W_
__W_______W__W_________W
_W_________WW__________W
_W_____________________W
_W___________________BBW
_W_____________B____BWWW
WW____W________P_W_BBW__
WD____W_________BWWWWW__
WWWWW_W________WWW______
____W_W___W_W_BW________
____W_WWWWWWWWWW________
____WWW_________________