__________________W_____
_________________W_W____
_______W________W___W___
______W_W______W_____W__
___WWW___W____W_______W_
__W_______W__W_________W
_W_________WW__________W
_W____________________BW
_W___________________BBW
_W___________________WWW
WW____W__________W___W__
WD____W_B______P_WWWWW__
WWWWW_W_B___B__WWW______
____W_W_B_W_WB_W________
____W_WWWWWWWWWW________
____WWW_________________