

## ####     
   # ##   # 
    ####   #
     #  B  #
   #    #   
##      #  #
### ##      
  #         


        ##  
BB       # #
   # #      
   # #      
 ##         
B##         
          ##
            


         #  
 #      B#  
  U ### ##  
  #    # ## 
       #   #
       #   #
##    #     
    ###  #  


  ##B#   #  
    B#####  
###     ##  
  #B        
         #  
            
   #### ##  
  B#  #B    


    ##   #  
      BB# ##
            
 #          
#     # ##  
#     #     
    #   ### 
    #B    ##


 ###  #    #
 #  # # ## #
   # #      
   # #      
           #
BB  B     B#
###    ###B#
  #  #    B#


  ###### # #
           #
     # #    
     ### #  
#D # #      
##B# ###    
####   #  # 
  ###     # 


  ##  ##    
#  #     #  
        B## 
        B## 
  ##   #### 
      #   # 
 ##         
 ###  B ##  


     ##     
   # ##     
      #     
    ###   B 
# ##        
#   #   B   
  #         
  #         


  #    #    
  ##   #    
    #     # 
    #   ### 
   #     # #
#  #     # #
    ##  ####
            
