

#D## B## B B## B
##  ### ####  ##


 B###### B B## B
##      ####  ##


 B## B## B B## B
############  ##


## B###### B## B
  ##  ##  ##  ##


#### B## B B B B
    ##  ########


 B## B B###D B B
##  ####  ######


######## B B B##
#   #   ######  


## B## B## B B##
  ##  ##  ####  


###D B###### B B
  ####      ####


######## B B## B
        ####  ##
