

   ###..............###   
 ##   ..............   #  
####B ..............B B## 
#  ## ..............# ## #
# ........................
..........................
..........................
..........................
..........................
..........................
..........................
..........................
..........................
..........................
..........................
..........................
 .....................BB# 
 .....................### 


   #.................##   
 #.................... #  
#.....................B## 
# .....................# #
..........................
..........................
..........................
..........................
..........................
..........................
..........................
..........................
..........................
..........................
..........................
..........................
 .....................BB# 
 .....................### 


   ###..............###   
 ##   ..............   #  
####B ..............  B## 
#  ##................ .# #
..........................
..........................
..........................
..........................
..........................
..........................
..........................
..........................
..........................
..........................
..........................
..........................
 .....................BB# 
 .....................### 


   #.................##   
 #.................... #  
#.....................B## 
# .....................# #
..........................
..........................
..........................
..........................
..........................
..........................
..........................
..........................
..........................
..........................
..........................
..........................
 .....................BB# 
 .....................### 


   #.................##   
 #.................... #  
#.....................B## 
# .....................# #
..........................
..........................
..........................
..........................
..........................
..........................
..........................
..........................
..........................
..........................
..........................
..........................
 .....................BB# 
 .....................### 


   ##................##   
 ##  ................  #  
####B................ B## 
#  ##................### #
# ........................
..........................
..........................
..........................
..........................
..........................
..........................
..........................
..........................
..........................
..........................
..........................
 .....................BB# 
 .....................### 


   ###...............##   
 ##   ...............  #  
####B ............... B## 
#  ..................### #
..........................
..........................
..........................
..........................
..........................
..........................
..........................
..........................
..........................
..........................
..........................
..........................
 .....................BB# 
 .....................### 


   #.................##   
 #.................... #  
#.....................B## 
# .....................# #
..........................
..........................
..........................
..........................
..........................
..........................
..........................
..........................
..........................
..........................
..........................
..........................
 .....................BB# 
 .....................### 


   #.................##   
 #.................... #  
#.....................B## 
# .....................# #
..........................
..........................
..........................
..........................
..........................
..........................
..........................
..........................
..........................
..........................
..........................
..........................
 .....................BB# 
 .....................### 


   ###...............##   
 ##   ...............  #  
####B ...............BB## 
#  ....................# #
..........................
..........................
..........................
..........................
..........................
..........................
..........................
..........................
..........................
..........................
..........................
..........................
 .....................BB# 
 .....................### 
