

             ###   
........... #   #..
...................
...................
...................
...................
...................
...................
...................
...................
...................
...................
...................
 ................  
 ................  


       ##    ##    
 ..   #  #  #  # ..
........  ##    ...
.......... ........
...................
...................
...................
...................
...................
...................
...................
...................
...................
 ................  
 ................  


       ##     ##.  
..... #  #.. # ....
........  .........
...................
...................
...................
...................
...................
...................
...................
...................
...................
...................
 ................  
 ................  


      ###          
 .   #   #.........
........  .........
...................
...................
...................
...................
...................
...................
...................
...................
...................
...................
 ................  
 ................  


         ##     .  
....... #  #.......
..........  .......
...................
...................
...................
...................
...................
...................
...................
...................
...................
...................
 ................  
 ................  


                   
      ...........  
   ## ...........  
  #  .......... ###
 #   ..........   #
#    ..........   #
#D   ..........  B#
##   .......... ###
 #   ..........    
 ### ............  
   # ............  
.................##
...................
 ................  
 ................  


            ####   
.......... #    #..
...................
...................
...................
...................
...................
...................
...................
...................
...................
...................
...................
 ................  
 ................  


        ##      .  
...... #  #........
.........  ........
...................
...................
...................
...................
...................
...................
...................
...................
...................
...................
 ................  
 ................  


         ##        
 ....   #  #   ..  
 ....  #    #  ..  
 .....#....  #..###
............  ..  #
...............   #
...................
...................
...................
...................
...................
...................
...................
 ................  
 ................  


   ###             
  #   #     .....  
 # ..  #    .....  
#  ...  #   .....  
#D ....  #  .....  
## .....  # .....  
 # ......  #.. ####
 ##......   ...#  #
   ............   #
...................
...................
...................
...................
 ................  
 ................  
