

 #  ##               
...   .............  
...................  
...................  
...................# 
 .................. #
 ....................
 ..................  
 ..................  


 #                   
.................    
..................#  
.................  # 
..................  #
 ....................
 ....................
 ..................  
 ..................  


 #          ##       
...........   ...    
..................#  
.................  # 
..................  #
 ....................
 ....................
 ..................  
 ..................  


 #  ##  ##           
...       #  .....   
......... .........# 
..................  #
.....................
 ....................
 ....................
 ..................  
 ..................  


 #   ##   ##         
....   ..   #    ..  
#..........  #   ..  
#...........  #  ..  
 ............ .......
 ....................
 ....................
 ..................  
 ..................  


 #            ##     
.............   #  ..
.....................
.....................
.....................
 ....................
 ....................
 ..................  
 ..................  


 #      ##           
.......   ........   
...................# 
..................  #
.....................
 ....................
 ....................
 ..................  
 ..................  


 #                   
..................   
...................# 
..................  #
.....................
 ....................
 ....................
 ..................  
 ..................  


 #  ##    ##  ##  .  
...   ...       .....
.....................
.....................
.....................
 ....................
 ....................
 ..................  
 ..................  


 #    ##             
.....   #  .......   
....... ...........# 
..................  #
.....................
 ....................
 ....................
 ..................  
 ..................  
