

 # ............   
 # ............## 
# #............  #
# ............   #
.............   B#
.............  BB#
.............B ## 
.............#....
..................
..................


 # ............   
 # ............## 
# #............  #
# ............   #
.............   B#
.............  BB#
.............B ## 
.............#....
..................
..................


 # ............   
 # ............## 
# #............  #
# ............   #
.............   B#
.............  BB#
.............B ## 
.............#....
..................
..................


 # ............   
 # ............## 
# #............  #
# ............   #
.............   B#
.............  BB#
.............B ## 
.............#....
..................
..................


 # ............   
 # ............## 
# #............  #
# ............   #
.............   B#
.............  BB#
.............B ## 
.............#....
..................
..................


 # ............   
 # ............## 
# #............  #
# ............   #
.............   B#
.............  BB#
.............B ## 
.............#....
..................
..................


 # ............   
 # ............## 
# #............  #
# ............   #
.............   B#
.............  BB#
.............B ## 
.............#....
..................
..................


 # ............   
 # ............## 
# #............  #
# ............   #
.............   B#
.............  BB#
.............B ## 
.............#....
..................
..................


 # ............   
 # ............## 
# #............  #
# ............   #
.............   B#
.............  BB#
.............B ## 
.............#....
..................
..................


 # ............   
 # ............## 
# #............  #
# ............   #
.............   B#
.............  BB#
.............B ## 
.............#....
..................
..................
