__________
____P_____
__________
___W______
___W_B____
_BBW_B_B__
WWWWWWWWWW
