__________
__W_______
_W________
W_________
W_________
W______PDW
WWWWWWWWWW
