WWWWWW
WW_P_W
WW_WDW
WW_WWW
WW___W
WWWWWW