__________
__________
_______D__
_______P__
___PD_____
__________
__________
____P__D__
__________
__________