__________
_____P____
________W_
____WB__W_
_B__W_____
BP_PW_B_BB
WWWWWWWWWW
