___W_____W
__W______W
_W_______W
W________W
W________W
W________W
WWWWWWWWWW
