_____W___P
B_____W_BB
_______WWW
___B______
B_BP_WP__B
BPBBBW___P
WWWWWWWWWW
