W____WW__.
W______W__
W_______W_
W________W
W________W
W________W
W._______W
...______W
W__W__W__W
WWWWWWWWWW
