WW___B____
_______P__
_______W__
_____B___B
___B___BBP
WD_PBP_PW_
WWWWWWWWWW
