________
______P_
___D____
________
________
_D______
_____P__
________