____________
_WWWWWWWWWW_
_BBBBBH___O_
____________
____________
____________
____________
____________
____________
_BBBBBH___O_
_WWWWWWWWWW_
WWWWWWWWWWWW