__________
__________
_______D__
__PD______
_______P__
__________
__D_______
__P_______
__________
__________