__________
__________
_______D__
__PD___P__
__________
__________
__D_______
__P_______
__________
__________