W_________
W_P_______
__________
__B____B__
W_PBBBBP__
W_WBWPW_WP
WWWWWWWWWW
