__________
__________
__________
__________
_B________
.W_W.P....
WWWWWWWWWW
