__W_WW____
__W__W____
__________
__B___B_P_
B__W_W_W_B
P_WWWW_WWB
WWWWWWWWWW
