__W_WW____
P_W__W__B_
__________
__________
___WBW_W_B
__WWWWBWWB
WWWWWWWWWW
