W_______W_
W______W__
_______W__
____PW_WB_
B___WW_WB_
BB_WWWBWBB
WWWWWWWWWW
