W_______W_
W______W__
_______W__
___P_W_WB_
____WW_WBP
BB_WWWBWBB
WWWWWWWWWW
