WWWWWWW
WWWWWWW
WW___WW
WW_WDWW
WW_WWWW
WW__PWW
WWWWWWW
WWWWWWW
       
WWWWWWW
WWWWWWW
WW___WW
WW_WDWW
WW_WWWW
WW_P_WW
WWWWWWW
WWWWWWW
       
WWWWWWW
WWWWWWW
WW___WW
WW_WDWW
WW_WWWW
WWP__WW
WWWWWWW
WWWWWWW
       
WWWWWWW
WWWWWWW
WW___WW
WW_WDWW
WWPWWWW
WW___WW
WWWWWWW
WWWWWWW
       
WWWWWWW
WWWWWWW
WW___WW
WWPWDWW
WW_WWWW
WW___WW
WWWWWWW
WWWWWWW
       
WWWWWWW
WWWWWWW
WWP__WW
WW_WDWW
WW_WWWW
WW___WW
WWWWWWW
WWWWWWW
       
WWWWWWW
WWWWWWW
WW_P_WW
WW_WDWW
WW_WWWW
WW___WW
WWWWWWW
WWWWWWW
       
WWWWWWW
WWWWWWW
WW__PWW
WW_WDWW
WW_WWWW
WW___WW
WWWWWWW
WWWWWWW
       
WWWWWWW
WWWWWWW
WW__PWW
WW_WDWW
WW_WWWW
WW___WW
WWWWWWW
WWWWWWW
       
WWWWWWW
WWWWWWW
WW__PWW
WW_WDWW
WW_WWWW
WW___WW
WWWWWWW
WWWWWWW
       
TTTTTTT
TTTTTTT
TTTTTTT
TTTTTTT
TTTTTTT
TTTTTTT
TTTTTTT
TTTTTTT
