WWWWWWW
WWWWWWW
WWP__WW
WWWW_WW
WWDW_WW
WW___WW
WWWWWWW
WWWWWWW
       
       
WWWWWWW
WWWWWWW
WW_P_WW
WWWW_WW
WWDW_WW
WW___WW
WWWWWWW
WWWWWWW
       
       
WWWWWWW
WWWWWWW
WW__PWW
WWWW_WW
WWDW_WW
WW___WW
WWWWWWW
WWWWWWW
       
       
WWWWWWW
WWWWWWW
WW___WW
WWWWPWW
WWDW_WW
WW___WW
WWWWWWW
WWWWWWW
       
       
WWWWWWW
WWWWWWW
WW___WW
WWWW_WW
WWDWPWW
WW___WW
WWWWWWW
WWWWWWW
       
       
WWWWWWW
WWWWWWW
WW___WW
WWWW_WW
WWDW_WW
WW__PWW
WWWWWWW
WWWWWWW
       
       
WWWWWWW
WWWWWWW
WW___WW
WWWW_WW
WWDW_WW
WW_P_WW
WWWWWWW
WWWWWWW
       
       
WWWWWWW
WWWWWWW
WW___WW
WWWW_WW
WWDW_WW
WWP__WW
WWWWWWW
WWWWWWW
       
       
WWWWWWW
WWWWWWW
WW___WW
WWWW_WW
WWDW_WW
WWP__WW
WWWWWWW
WWWWWWW
       
       
WWWWWWW
WWWWWWW
WW___WW
WWWW_WW
WWDW_WW
WWP__WW
WWWWWWW
WWWWWWW
       
       
TTTTTTT
TTTTTTT
TTTTTTT
TTTTTTT
TTTTTTT
TTTTTTT
TTTTTTT
TTTTTTT
