________
__P__D__
__D_____
______P_
________
________
_D____P_
________