________
__P__DP_
__D_____
________
________
________
_D__P___
________