________
________
_____D__
__D_____
_____P__
__P_____
________
________