_WWWWWW_WW
__________
__________
__________
___BB__WP_
__WBP__WW_
WWWWWWWWWW
