__________
__________
__________
__________
_________.
........_.
..........
