BW__P_B_W_
WWB_W_P_W_
__WWW____W
_________W
BP___B__BW
W_WBW_WPBW
WWWWWWWWWW
