..........
..........
..........
..........
..........
..........
.......P..
..........
..........
WWWWWWWWWW
