B__W_W____
WWW___W___
W_____W___
______WB__
___B_PWB__
W_WB_BWBB_
WWWWWWWWWW
