B__W_W___P
WWW___W___
W_____W___
______WB__
___B__WB__
W_WBPBWBBB
WWWWWWWWWW
