_______WWW
__________
___B______
___P___B__
___B_B_P_B
__PBWPWBWP
WWWWWWWWWW
