_______WWW
__________
___B______
___P___B__
___B___P__
___BW_WBW_
WWWWWWWWWW
