_.___WW___
_.W_______
_PW_B_____
_PW_P___B_
_BW_B_B_PB
BWWWBBB_WB
WWWWWWWWWW
