_____WW___
__W_______
BPW____B__
_BWP_B_P_P
_BW_BP___B
BWWWBBB_WB
WWWWWWWWWW
