DW____W___
WW____W___
__________
__________
___BP_P_BB
PBBBW_B_B_
WWWWWWWWWW
