DW____W___
WW____W___
__________
____B__B__
__PBP___BB
_BBBW_BPB_
WWWWWWWWWW
