

 B#### B## B####
##  ####  ##    


 B B B## B#D B##
######  ######  


 B B#### B#####D
####  ####  ####


 B## B###### B##
######      ##  


 U B###########D
####        ####


 B## B B###### B
##  ####      ##


## B B B## B B##
########  ####  


 B B#########D B
####  ##    ####


 B######## B B##
##        ####  


#### B#D U## B B
  ########  ####
