___W_W.__W
___W_W.__W
___WWW....
__..__....
_W_______W
W________W
W________W
W____WP__W
W___BW__DW
WWWWWWWWWW
