___W.W___W
___W.W___W
___W.W___W
__WW_____W
_W_______W
W________W
W________W
W____W___W
W___BW_PDW
WWWWWWWWWW
