__________
______P___
______WB__
_____BW___
_B___BW_W_
WPW_BBW_WW
WWWWWWWWWW
