(12, 6, 5)
_ _ _ _ _
_ _ _ _ _
_ O _ _ _
_ _ _ _ _
_ P _ B _
_ _ _ _ _

***

_ _ _ _ _
_ _ _ _ _
_ O _ _ _
_ _ _ _ _
_ _ P B _
_ _ _ _ _

***

_ _ _ _ _
_ _ _ _ _
_ O _ _ _
_ _ _ _ _
_ _ _ B _
_ _ P _ _

***

_ _ _ _ _
_ _ _ _ _
_ O _ _ _
_ _ _ _ _
_ _ _ B _
_ _ _ P _

***

_ _ _ _ _
_ _ _ _ _
_ O _ _ _
_ _ _ B _
_ _ _ P _
_ _ _ _ _

***

_ _ _ _ _
_ _ _ _ _
_ O _ B _
_ _ _ P _
_ _ _ _ _
_ _ _ _ _

***

_ _ _ _ _
_ _ _ _ _
_ O _ B _
_ _ _ _ P
_ _ _ _ _
_ _ _ _ _

***

_ _ _ _ _
_ _ _ _ _
_ O _ B P
_ _ _ _ _
_ _ _ _ _
_ _ _ _ _

***

_ _ _ _ _
_ _ _ _ _
_ O B P _
_ _ _ _ _
_ _ _ _ _
_ _ _ _ _

***

_ _ _ _ _
_ _ _ _ _
_ G P _ _
_ _ _ _ _
_ _ _ _ _
_ _ _ _ _

***

_ _ _ _ _
_ _ _ _ _
_ G P _ _
_ _ _ _ _
_ _ _ _ _
_ _ _ _ _

***

_ _ _ _ _
_ _ _ _ _
_ G P _ _
_ _ _ _ _
_ _ _ _ _
_ _ _ _ _

***

