[
    [
        ["W","W","W","W","W","W"],
        ["W","_","_","_","O","W"],
        ["W","_","_","B","_","W"],
        ["W","O","W","_","_","W"],
        ["W","P","W","B","_","W"],
        ["W","_","_","_","_","W"],
        ["W","W","W","W","W","W"]
    ],
    [
        ["W","W","W","W","W","W"],
        ["W","_","_","_","O","W"],
        ["W","_","_","B","_","W"],
        ["W","O","W","_","_","W"],
        ["W","_","W","B","_","W"],
        ["W","P","_","_","_","W"],
        ["W","W","W","W","W","W"]
    ],
    [
        ["W","W","W","W","W","W"],
        ["W","_","_","_","O","W"],
        ["W","_","_","B","_","W"],
        ["W","O","W","_","_","W"],
        ["W","_","W","B","_","W"],
        ["W","_","P","_","_","W"],
        ["W","W","W","W","W","W"]
    ],
    [
        ["W","W","W","W","W","W"],
        ["W","_","_","_","O","W"],
        ["W","_","_","B","_","W"],
        ["W","O","W","_","_","W"],
        ["W","_","W","B","_","W"],
        ["W","_","_","P","_","W"],
        ["W","W","W","W","W","W"]
    ],
    [
        ["W","W","W","W","W","W"],
        ["W","_","_","_","O","W"],
        ["W","_","_","B","_","W"],
        ["W","O","W","_","_","W"],
        ["W","_","W","B","_","W"],
        ["W","_","_","_","P","W"],
        ["W","W","W","W","W","W"]
    ],
    [
        ["W","W","W","W","W","W"],
        ["W","_","_","_","O","W"],
        ["W","_","_","B","_","W"],
        ["W","O","W","_","_","W"],
        ["W","_","W","B","P","W"],
        ["W","_","_","_","_","W"],
        ["W","W","W","W","W","W"]
    ],
    [
        ["W","W","W","W","W","W"],
        ["W","_","_","_","O","W"],
        ["W","_","_","B","_","W"],
        ["W","O","W","_","P","W"],
        ["W","_","W","B","_","W"],
        ["W","_","_","_","_","W"],
        ["W","W","W","W","W","W"]
    ],
    [
        ["W","W","W","W","W","W"],
        ["W","_","_","_","O","W"],
        ["W","_","_","B","_","W"],
        ["W","O","W","P","_","W"],
        ["W","_","W","B","_","W"],
        ["W","_","_","_","_","W"],
        ["W","W","W","W","W","W"]
    ],
    [
        ["W","W","W","W","W","W"],
        ["W","_","_","B","O","W"],
        ["W","_","_","P","_","W"],
        ["W","O","W","_","_","W"],
        ["W","_","W","B","_","W"],
        ["W","_","_","_","_","W"],
        ["W","W","W","W","W","W"]
    ],
    [
        ["W","W","W","W","W","W"],
        ["W","_","_","B","O","W"],
        ["W","_","P","_","_","W"],
        ["W","O","W","_","_","W"],
        ["W","_","W","B","_","W"],
        ["W","_","_","_","_","W"],
        ["W","W","W","W","W","W"]
    ],
    [
        ["W","W","W","W","W","W"],
        ["W","_","P","B","O","W"],
        ["W","_","_","_","_","W"],
        ["W","O","W","_","_","W"],
        ["W","_","W","B","_","W"],
        ["W","_","_","_","_","W"],
        ["W","W","W","W","W","W"]
    ],
    [
        ["W","W","W","W","W","W"],
        ["W","_","_","P","G","W"],
        ["W","_","_","_","_","W"],
        ["W","O","W","_","_","W"],
        ["W","_","W","B","_","W"],
        ["W","_","_","_","_","W"],
        ["W","W","W","W","W","W"]
    ],
    [
        ["W","W","W","W","W","W"],
        ["W","_","_","_","G","W"],
        ["W","_","_","P","_","W"],
        ["W","O","W","_","_","W"],
        ["W","_","W","B","_","W"],
        ["W","_","_","_","_","W"],
        ["W","W","W","W","W","W"]
    ],
    [
        ["W","W","W","W","W","W"],
        ["W","_","_","_","G","W"],
        ["W","_","_","_","P","W"],
        ["W","O","W","_","_","W"],
        ["W","_","W","B","_","W"],
        ["W","_","_","_","_","W"],
        ["W","W","W","W","W","W"]
    ],
    [
        ["W","W","W","W","W","W"],
        ["W","_","_","_","G","W"],
        ["W","_","_","_","_","W"],
        ["W","O","W","_","P","W"],
        ["W","_","W","B","_","W"],
        ["W","_","_","_","_","W"],
        ["W","W","W","W","W","W"]
    ],
    [
        ["W","W","W","W","W","W"],
        ["W","_","_","_","G","W"],
        ["W","_","_","_","_","W"],
        ["W","O","W","_","_","W"],
        ["W","_","W","B","P","W"],
        ["W","_","_","_","_","W"],
        ["W","W","W","W","W","W"]
    ],
    [
        ["W","W","W","W","W","W"],
        ["W","_","_","_","G","W"],
        ["W","_","_","_","_","W"],
        ["W","O","W","_","_","W"],
        ["W","_","W","B","_","W"],
        ["W","_","_","_","P","W"],
        ["W","W","W","W","W","W"]
    ],
    [
        ["W","W","W","W","W","W"],
        ["W","_","_","_","G","W"],
        ["W","_","_","_","_","W"],
        ["W","O","W","_","_","W"],
        ["W","_","W","B","_","W"],
        ["W","_","_","P","_","W"],
        ["W","W","W","W","W","W"]
    ],
    [
        ["W","W","W","W","W","W"],
        ["W","_","_","_","G","W"],
        ["W","_","_","_","_","W"],
        ["W","O","W","B","_","W"],
        ["W","_","W","P","_","W"],
        ["W","_","_","_","_","W"],
        ["W","W","W","W","W","W"]
    ],
    [
        ["W","W","W","W","W","W"],
        ["W","_","_","_","G","W"],
        ["W","_","_","B","_","W"],
        ["W","O","W","P","_","W"],
        ["W","_","W","_","_","W"],
        ["W","_","_","_","_","W"],
        ["W","W","W","W","W","W"]
    ],
    [
        ["W","W","W","W","W","W"],
        ["W","_","_","_","G","W"],
        ["W","_","_","B","_","W"],
        ["W","O","W","_","P","W"],
        ["W","_","W","_","_","W"],
        ["W","_","_","_","_","W"],
        ["W","W","W","W","W","W"]
    ],
    [
        ["W","W","W","W","W","W"],
        ["W","_","_","_","G","W"],
        ["W","_","_","B","P","W"],
        ["W","O","W","_","_","W"],
        ["W","_","W","_","_","W"],
        ["W","_","_","_","_","W"],
        ["W","W","W","W","W","W"]
    ],
    [
        ["W","W","W","W","W","W"],
        ["W","_","_","_","G","W"],
        ["W","_","B","P","_","W"],
        ["W","O","W","_","_","W"],
        ["W","_","W","_","_","W"],
        ["W","_","_","_","_","W"],
        ["W","W","W","W","W","W"]
    ],
    [
        ["W","W","W","W","W","W"],
        ["W","_","_","_","G","W"],
        ["W","B","P","_","_","W"],
        ["W","O","W","_","_","W"],
        ["W","_","W","_","_","W"],
        ["W","_","_","_","_","W"],
        ["W","W","W","W","W","W"]
    ],
    [
        ["W","W","W","W","W","W"],
        ["W","_","P","_","G","W"],
        ["W","B","_","_","_","W"],
        ["W","O","W","_","_","W"],
        ["W","_","W","_","_","W"],
        ["W","_","_","_","_","W"],
        ["W","W","W","W","W","W"]
    ],
    [
        ["W","W","W","W","W","W"],
        ["W","P","_","_","G","W"],
        ["W","B","_","_","_","W"],
        ["W","O","W","_","_","W"],
        ["W","_","W","_","_","W"],
        ["W","_","_","_","_","W"],
        ["W","W","W","W","W","W"]
    ],
    [
        ["W","W","W","W","W","W"],
        ["W","_","_","_","G","W"],
        ["W","P","_","_","_","W"],
        ["W","G","W","_","_","W"],
        ["W","_","W","_","_","W"],
        ["W","_","_","_","_","W"],
        ["W","W","W","W","W","W"]
    ],
    [
        ["W","W","W","W","W","W"],
        ["W","_","_","_","G","W"],
        ["W","P","_","_","_","W"],
        ["W","G","W","_","_","W"],
        ["W","_","W","_","_","W"],
        ["W","_","_","_","_","W"],
        ["W","W","W","W","W","W"]
    ],
    [
        ["W","W","W","W","W","W"],
        ["W","_","_","_","G","W"],
        ["W","P","_","_","_","W"],
        ["W","G","W","_","_","W"],
        ["W","_","W","_","_","W"],
        ["W","_","_","_","_","W"],
        ["W","W","W","W","W","W"]
    ]
]