W___..___W
W________W
W________W
W________W
W___.____W
W___...__W
W________W
W____W___W
W____W__DW
WWWWWWWWWW
