______________________
______________________
______________________
____BBB_______________
____VWB_______________
__BBVWB__BBB___BBB____
__VBBWB__VWB___VWH____
_BBBVWBBBVWBBBBVW___O_
_WWWWWWWWWWWWWWWWWWWW_
WWWWWWWWWWWWWWWWWWWWWW