__________
________W_
B_B_____W_
__P_____W_
__W____WW_
W_WB_PBWD_
WWWWWWWWWW
