__________
________W_
________W_
__P_____W_
B_W____WW_
W_WBP_PWD_
WWWWWWWWWW
