_____B____
P____P__WP
_______PW_
________W_
BPW____WW_
W_WB__BWD_
WWWWWWWWWW
