W W W W W W W W
W _ W W W W W W
W _ W W _ _ _ W
W W W W _ W W W
W W W W _ W D W
W _ W W _ _ P W
W _ W W W W W W
W W W W W W W W