WW_P___WW_
_W_____WWB
___B_____W
__BB______
_B_B___WP_
_PBWBPBWWB
WWWWWWWWWW
