. . P . . .
. . . . . .
. . . . . .
. . . . . .
D . . . . .
. . . . . .