__________
_WWWWWWWW_
W________W
W________W
W____.....
W___W.....
WWWWW.....
