_________
_________
_________
____W____
_BBHW__O_
_WWWWWWW_
WWWWWWWWW