W________W
W________W
W________W
W________W
W________W
W__W__W__W
WWWWWWWWWW
