_________B
_________W
_________W
_B_P__W___
_B_P__W_P_
_BBW__W__B
WWWWWWWWWW
