__________
_________W
_________W
_B____W___
_B____W_B_
_BBWP_W_P_
WWWWWWWWWW
