P_________
_________W
_________W
_B____W___
_B_P__W_B_
_BBW__W_P_
WWWWWWWWWW
