_ _ _ _ _ _
_ P B O _ _
_ _ _ _ _ _
_ _ _ _ _ _
_ _ P G _ _
_ _ _ _ _ _

***

_ _ _ _ _ _
_ _ P G _ _
_ _ _ _ _ _
_ _ _ _ _ _
_ _ P G _ _
_ _ _ _ _ _

***

_ _ _ _ _ _
_ _ P G _ _
_ _ _ _ _ _
_ _ _ _ _ _
_ _ P G _ _
_ _ _ _ _ _

***

_ _ _ _ _ _
_ _ P G _ _
_ _ _ _ _ _
_ _ _ _ _ _
_ _ P G _ _
_ _ _ _ _ _

***

_ _ _ _ _ _
_ _ P G _ _
_ _ _ _ _ _
_ _ _ _ _ _
_ _ P G _ _
_ _ _ _ _ _

***

_ _ _ _ _ _
_ _ P G _ _
_ _ _ _ _ _
_ _ _ _ _ _
_ _ P G _ _
_ _ _ _ _ _

***

_ _ _ _ _ _
_ _ P G _ _
_ _ _ _ _ _
_ _ _ _ _ _
_ _ P G _ _
_ _ _ _ _ _

***

T T T T T T
T T T T T T
T T T T T T
T T T T T T
T T T T T T
T T T T T T

***

