_ _ _ _ _ _
_ _ _ _ _ _
_ _ _ _ _ _
_ _ _ P _ _
_ O _ B _ _
_ _ _ _ _ _

***

_ _ _ _ _ _
_ _ _ _ _ _
_ _ _ _ _ _
_ _ _ _ P _
_ O _ B _ _
_ _ _ _ _ _

***

_ _ _ _ _ _
_ _ _ _ _ _
_ _ _ _ _ _
_ _ _ _ _ _
_ O _ B P _
_ _ _ _ _ _

***

_ _ _ _ _ _
_ _ _ _ _ _
_ _ _ _ _ _
_ _ _ _ _ _
_ O B P _ _
_ _ _ _ _ _

***

_ _ _ _ _ _
_ _ _ _ _ _
_ _ _ _ _ _
_ _ _ _ _ _
_ G P _ _ _
_ _ _ _ _ _

***

_ _ _ _ _ _
_ _ _ _ _ _
_ _ _ _ _ _
_ _ _ _ _ _
_ G P _ _ _
_ _ _ _ _ _

***

_ _ _ _ _ _
_ _ _ _ _ _
_ _ _ _ _ _
_ _ _ _ _ _
_ G P _ _ _
_ _ _ _ _ _

***

T T T T T T
T T T T T T
T T T T T T
T T T T T T
T T T T T T
T T T T T T

***

