W________.
W________.
W________.
W_______P.
W_______W.
W___W__BW.
WWWWWWWWW.
