W____D_WW_
W__B_W___W
_____W____
_______B__
__B____P_P
_BBP__WBBW
WWWWWWWWWW
