W___W.W__W
W___W_W__W
W___W.W__W
W________W
W________W
W__W_____W
WWWWWWWWWW
