W__________W
W,,,,,,,,,,W
W,,,,,,,,,,W
W,,,,,,,,,,W
W,,,,,,,,,,W
WWWWWWWWWWWW
            
W__________W
W,,,,,,,,,,W
W,,,,,,,,,,W
W,,,,,,,,,,W
W,,,,,,,,,,W
WWWWWWWWWWWW
            
W__________W
W,,,,,,,,,,W
W,,,,,,,,,,W
W,,,,,,,,,,W
W,,,,,,,,,,W
WWWWWWWWWWWW
            
W__________W
W,,,,,,,,,,W
W,,,,,,,,,,W
W,,,,,,,,,,W
W,,,,,,,,,,W
WWWWWWWWWWWW
            
W__________W
W,,,,,,,,,,W
W,,,,,,,,,,W
W,,,,,,,,,,W
W,,,,,,,,,,W
WWWWWWWWWWWW
            
W__________W
W,,,,,,,,,,W
W,,,,,,,,,,W
W,,,,,,,,,,W
W,,,,,,,,,,W
WWWWWWWWWWWW
            
W__________W
W,,,,,,,,,,W
W,,,,,,,,,,W
W,,,,,,,,,,W
W,,,,,,,,,,W
WWWWWWWWWWWW
            
W__________W
W,,,,,,,,,,W
W,,,,,,,,,,W
W,,,,,,,,,,W
W,,,,,,,,,,W
WWWWWWWWWWWW
            
W__________W
W,,,,,,,,,,W
W,,,,,,,,,,W
W,,,,,,,,,,W
W,,,,,,,,,,W
WWWWWWWWWWWW
            
W__________W
W,,,,,,,,,,W
W,,,,,,,,,,W
W,,,,,,,,,,W
W,,,,,,,,,,W
WWWWWWWWWWWW
            
W__________W
W,,,,,,,,,,W
W,,,,,,,,,,W
W,,,,,,,,,,W
W,,,,,,,,,,W
WWWWWWWWWWWW
            
W__________W
W,,,,,,,,,,W
W,,,,,,,,,,W
W,,,,,,,,,,W
W,,,,,,,,,,W
WWWWWWWWWWWW
            
W__________W
W,,,,,,,,,,W
W,,,,,,,,,,W
W,,,,,,,,,,W
W,,,,,,,,,,W
WWWWWWWWWWWW
            
W__________W
W,,,,,,,,,,W
W,,,,,,,,,,W
W,,,,,,,,,,W
W,,,,,,,,,,W
WWWWWWWWWWWW
            
W__________W
W,,,,,,,,,,W
W,,,,,,,,,,W
W,,,,,,,,,,W
W,,,,,,,,,,W
WWWWWWWWWWWW
