B_______WW
__B_______
__P___P___
__WB__BB__
P_WB__B__B
B_WB_BWB_P
WWWWWWWWWW
