__________
B_____B___
W_____P__B
__B___B__P
__P___B__B
___B_PB_BB
WWWWWWWWWW
