________
________
__B_____
________
__P_O___
________
________
        
________
________
__B_____
__P_____
____O___
________
________
        
________
________
__B_____
_P______
____O___
________
________
        
________
________
_PB_____
________
____O___
________
________
        
________
________
__PB____
________
____O___
________
________
        
________
________
___PB___
________
____O___
________
________
        
________
___P____
____B___
________
____O___
________
________
        
________
____P___
____B___
________
____O___
________
________
        
________
________
____P___
____B___
____O___
________
________
        
________
________
________
____P___
____G___
________
________
        
________
________
________
____P___
____G___
________
________
        
________
________
________
____P___
____G___
________
________
        
TTTTTTTT
TTTTTTTT
TTTTTTTT
TTTTTTTT
TTTTTTTT
TTTTTTTT
TTTTTTTT
