________
________
___O_P__
________
_____B__
________
________
        
________
________
___O____
_____P__
_____B__
________
________
        
________
________
___O____
______P_
_____B__
________
________
        
________
________
___O____
________
_____BP_
________
________
        
________
________
___O____
________
____BP__
________
________
        
________
________
___O____
________
___BP___
________
________
        
________
________
___O____
________
___B____
____P___
________
        
________
________
___O____
________
___B____
___P____
________
        
________
________
___O____
___B____
___P____
________
________
        
________
________
___G____
___P____
________
________
________
        
________
________
___G____
___P____
________
________
________
        
________
________
___G____
___P____
________
________
________
        
TTTTTTTT
TTTTTTTT
TTTTTTTT
TTTTTTTT
TTTTTTTT
TTTTTTTT
TTTTTTTT
