W W W W W
W _ P _ W
W D W _ W
W W W _ W
W _ _ _ W
W W W W W