_WW___P_B_
______W_B_
______WWW_
________W_
_W____B_WB
PWWB_BB_W_
WWWWWWWWWW
