_____P____
_____B____
_D___W____
_W________
______BB_B
D_DW_BBBPB
WWWWWWWWWW
