________
______P_
____D___
_D______
________
____D___
_P____P_
________