________
____P___
____D___
_D______
________
____D___
_P__P___
________