..___B___.
___PBB____
_WWWWWWWW_
W________W
W________W
W___B____W
WWWWWWWWWW
