.___...__.
____..____
_WWWWWWWW_
W________W
W________W
W___B____W
WWWWWWWWWW
