

#### U B B#### B
#   ######  ####


########## B B##
          ####  


 B B## B###### B
####  ##      ##


#### B#### B####
    ##    ##    


 B#### B B## B B
##    ####  ####


 B B B B B######
##########      


## B#### B#### U
  ##    ##    ##


 B B B B B###D B
##########  ####


## B## B## B B B
  ##  ##  ######


#####D## U#### B
##  ##  ##    ##
