

#   # U   
##  # ##  
#D  #    #
##  # #  #


    # #   
    ####  
 #B   B # 
##########


  #D    # 
  ##    # 
      #   
    ####  


 #  #D  # 
##  ##  ##
  B   B  #
  ###### #


#       # 
#     # ##
 ## B     
 ## ##    


      #   
    ####  
 #  # #  #
 ####### #


   # #  # 
   # #  # 
  # # # B 
# # # # ##


     ## # 
     #####
   # #    
   # #    


U #D      
####    ##
B         
######    


        B 
#   ##  ##
        # 
        ##
