__________
__________
__P_______
____P___B_
__W_W_B_B_
PW___WP_PB
WWWWWWWWWW
