__________
__________
__________
__P_P_____
__W_W_B_B_
_W___WP_PB
WWWWWWWWWW
