__________
__________
_______P__
__________
__________
__________
__________
__D_______
__________
__________
          
          
__________
__________
__________
_______P__
__________
__________
__________
__D_______
__________
__________
          
          
__________
__________
__________
__________
_______P__
__________
__________
__D_______
__________
__________
          
          
__________
__________
__________
__________
__________
_______P__
__________
__D_______
__________
__________
          
          
__________
__________
__________
__________
__________
__________
_______P__
__D_______
__________
__________
          
          
__________
__________
__________
__________
__________
__________
__________
__D____P__
__________
__________
          
          
__________
__________
__________
__________
__________
__________
__________
__D___P___
__________
__________
          
          
__________
__________
__________
__________
__________
__________
__________
__D__P____
__________
__________
          
          
__________
__________
__________
__________
__________
__________
__________
__D_P_____
__________
__________
          
          
__________
__________
__________
__________
__________
__________
__________
__DP______
__________
__________
          
          
__________
__________
__________
__________
__________
__________
__________
__DP______
__________
__________
          
          
__________
__________
__________
__________
__________
__________
__________
__DP______
__________
__________
          
          
TTTTTTTTTT
TTTTTTTTTT
TTTTTTTTTT
TTTTTTTTTT
TTTTTTTTTT
TTTTTTTTTT
TTTTTTTTTT
TTTTTTTTTT
TTTTTTTTTT
TTTTTTTTTT
