__________
__________
_______P__
__________
__________
__________
__________
__D_______
__________
__________
          
          
__________
__________
______P___
__________
__________
__________
__________
__D_______
__________
__________
          
          
__________
__________
_____P____
__________
__________
__________
__________
__D_______
__________
__________
          
          
__________
__________
____P_____
__________
__________
__________
__________
__D_______
__________
__________
          
          
__________
__________
___P______
__________
__________
__________
__________
__D_______
__________
__________
          
          
__________
__________
__P_______
__________
__________
__________
__________
__D_______
__________
__________
          
          
__________
__________
__________
__P_______
__________
__________
__________
__D_______
__________
__________
          
          
__________
__________
__________
__________
__P_______
__________
__________
__D_______
__________
__________
          
          
__________
__________
__________
__________
__________
__P_______
__________
__D_______
__________
__________
          
          
__________
__________
__________
__________
__________
__________
__P_______
__D_______
__________
__________
          
          
__________
__________
__________
__________
__________
__________
__P_______
__D_______
__________
__________
          
          
__________
__________
__________
__________
__________
__________
__P_______
__D_______
__________
__________
          
          
TTTTTTTTTT
TTTTTTTTTT
TTTTTTTTTT
TTTTTTTTTT
TTTTTTTTTT
TTTTTTTTTT
TTTTTTTTTT
TTTTTTTTTT
TTTTTTTTTT
TTTTTTTTTT
