__________
__________
__P_______
__________
__________
__________
__________
_______D__
__________
__________
          
__________
__________
__________
__P_______
__________
__________
__________
_______D__
__________
__________
          
__________
__________
__________
__________
__P_______
__________
__________
_______D__
__________
__________
          
__________
__________
__________
__________
__________
__P_______
__________
_______D__
__________
__________
          
__________
__________
__________
__________
__________
__________
__P_______
_______D__
__________
__________
          
__________
__________
__________
__________
__________
__________
__________
__P____D__
__________
__________
          
__________
__________
__________
__________
__________
__________
__________
___P___D__
__________
__________
          
__________
__________
__________
__________
__________
__________
__________
____P__D__
__________
__________
          
__________
__________
__________
__________
__________
__________
__________
_____P_D__
__________
__________
          
__________
__________
__________
__________
__________
__________
__________
______PD__
__________
__________
          
__________
__________
__________
__________
__________
__________
__________
______PD__
__________
__________
          
__________
__________
__________
__________
__________
__________
__________
______PD__
__________
__________
          
TTTTTTTTTT
TTTTTTTTTT
TTTTTTTTTT
TTTTTTTTTT
TTTTTTTTTT
TTTTTTTTTT
TTTTTTTTTT
TTTTTTTTTT
TTTTTTTTTT
TTTTTTTTTT
